Pop_2000,State,County,Pop_2016,geoid,Pop_Change
43671,01,001,55416,01001,11745
140415,01,003,208563,01003,68148
29038,01,005,25965,01005,-3073
20826,01,007,22643,01007,1817
51024,01,009,57704,01009,6680
11714,01,011,10362,01011,-1352
21399,01,013,19998,01013,-1401
112249,01,015,114611,01015,2362
36583,01,017,33843,01017,-2740
23988,01,019,25725,01019,1737
39593,01,021,43941,01021,4348
15922,01,023,12993,01023,-2929
27867,01,025,24392,01025,-3475
14254,01,027,13492,01027,-762
14123,01,029,14924,01029,801
43615,01,031,51226,01031,7611
54984,01,033,54216,01033,-768
14089,01,035,12395,01035,-1694
12202,01,037,10581,01037,-1621
37631,01,039,37458,01039,-173
13665,01,041,13913,01041,248
77483,01,043,82471,01043,4988
49129,01,045,49226,01045,97
46365,01,047,40008,01047,-6357
64452,01,049,70900,01049,6448
65874,01,051,81799,01051,15925
38440,01,053,37728,01053,-712
103459,01,055,102564,01055,-895
18495,01,057,16546,01057,-1949
31223,01,059,31628,01059,405
25764,01,061,26614,01061,850
9974,01,063,8422,01063,-1552
17185,01,065,14952,01065,-2233
16310,01,067,17164,01067,854
88787,01,069,104056,01069,15269
53926,01,071,52138,01071,-1788
662047,01,073,659521,01073,-2526
15904,01,075,13918,01075,-1986
87966,01,077,92318,01077,4352
34803,01,079,33244,01079,-1559
115092,01,081,158991,01081,43899
65676,01,083,92753,01083,27077
13473,01,085,10358,01085,-3115
24105,01,087,18963,01087,-5142
276700,01,089,356967,01089,80267
22539,01,091,19673,01091,-2866
31214,01,093,29998,01093,-1216
82231,01,095,95157,01095,12926
399843,01,097,414836,01097,14993
24324,01,099,21530,01099,-2794
223510,01,101,226349,01101,2839
111064,01,103,119012,01103,7948
11861,01,105,9574,01105,-2287
20949,01,107,20324,01107,-625
29605,01,109,33286,01109,3681
22380,01,111,22652,01111,272
49756,01,113,58172,01113,8416
64742,01,115,88019,01115,23277
143293,01,117,210622,01117,67329
14798,01,119,13040,01119,-1758
80321,01,121,80103,01121,-218
41475,01,123,40727,01123,-748
164875,01,125,206102,01125,41227
70713,01,127,64967,01127,-5746
18097,01,129,16756,01129,-1341
13183,01,131,10986,01131,-2197
24843,01,133,23805,01133,-1038
2697,02,013,3296,02013,599
5465,02,016,5647,02016,182
260283,02,020,298192,02020,37909
16006,02,050,17968,02050,1962
1258,02,060,898,02060,-360
1893,02,068,1953,02068,60
4922,02,070,4954,02070,32
82840,02,090,100605,02090,17765
2392,02,100,2496,02100,104
30711,02,110,32468,02110,1757
49691,02,122,58506,02122,8815
14070,02,130,13746,02130,-324
13913,02,150,13732,02150,-181
1823,02,164,1562,02164,-261
59322,02,170,104365,02170,45043
9196,02,180,9917,02180,721
7385,02,185,9606,02185,2221
7208,02,188,7673,02188,465
6146,02,201,,02201,
8835,02,220,8830,02220,-5
3436,02,232,,02232,
6174,02,240,6876,02240,702
10195,02,261,9355,02261,-840
7028,02,270,,02270,
6684,02,280,,02280,
808,02,282,601,02282,-207
6551,02,290,5526,02290,-1025
69423,04,001,73112,04001,3689
117755,04,003,125770,04003,8015
116320,04,005,140908,04005,24588
51335,04,007,53556,04007,2221
33489,04,009,37599,04009,4110
8547,04,011,9613,04011,1066
19715,04,012,20317,04012,602
3072149,04,013,4242997,04013,1170848
155032,04,015,205249,04015,50217
97470,04,017,110026,04017,12556
843746,04,019,1016206,04019,172460
179727,04,021,418540,04021,238813
38381,04,023,45985,04023,7604
167517,04,025,225562,04025,58045
160026,04,027,205631,04027,45605
20749,05,001,18214,05001,-2535
24209,05,003,20492,05003,-3717
38386,05,005,41062,05005,2676
153406,05,007,258291,05007,104885
33948,05,009,37304,05009,3356
12600,05,011,10996,05011,-1604
5744,05,013,5144,05013,-600
25357,05,015,27646,05015,2289
14117,05,017,10945,05017,-3172
23546,05,019,22657,05019,-889
17609,05,021,14920,05021,-2689
24046,05,023,25264,05023,1218
8571,05,025,8241,05025,-330
25603,05,027,23901,05027,-1702
20336,05,029,20937,05029,601
82148,05,031,105835,05031,23687
53247,05,033,62267,05033,9020
50866,05,035,49235,05035,-1631
19526,05,037,17037,05037,-2489
9210,05,039,7469,05039,-1741
15341,05,041,11876,05041,-3465
18723,05,043,18651,05043,-72
86014,05,045,122227,05045,36213
17771,05,047,17626,05047,-145
11642,05,049,12123,05049,481
88068,05,051,97477,05051,9409
16464,05,053,18082,05053,1618
37331,05,055,44598,05055,7267
23587,05,057,21974,05057,-1613
30353,05,059,33374,05059,3021
14300,05,061,13377,05061,-923
34233,05,063,37168,05063,2935
13249,05,065,13433,05065,184
18418,05,067,17221,05067,-1197
84278,05,069,70016,05069,-14262
22781,05,071,26176,05071,3395
8559,05,073,6847,05073,-1712
17774,05,075,16735,05075,-1039
12580,05,077,9310,05077,-3270
14492,05,079,13705,05079,-787
13628,05,081,12451,05081,-1177
22486,05,083,21792,05083,-694
52828,05,085,72228,05085,19400
14243,05,087,16072,05087,1829
16140,05,089,16325,05089,185
40443,05,091,43787,05091,3344
51979,05,093,42835,05093,-9144
10254,05,095,7169,05095,-3085
9245,05,097,8879,05097,-366
9955,05,099,8398,05099,-1557
8608,05,101,7936,05101,-672
28790,05,103,24098,05103,-4692
10209,05,105,10132,05105,-77
26445,05,107,18975,05107,-7470
11303,05,109,10832,05109,-471
25614,05,111,24023,05111,-1591
20229,05,113,20173,05113,-56
54469,05,115,63779,05115,9310
9539,05,117,8251,05117,-1288
361474,05,119,393250,05119,31776
18195,05,121,17448,05121,-747
29329,05,123,26196,05123,-3133
83529,05,125,118703,05125,35174
10996,05,127,10277,05127,-719
8261,05,129,7967,05129,-294
115071,05,131,127793,05131,12722
15757,05,133,16910,05133,1153
17119,05,135,17157,05135,38
11499,05,137,12539,05137,1040
45629,05,139,39887,05139,-5742
16192,05,141,16628,05141,436
157715,05,143,228049,05143,70334
67165,05,145,79263,05145,12098
8741,05,147,6641,05147,-2100
21139,05,149,21552,05149,413
1443741,06,001,1647704,06001,203963
1208,06,003,1071,06003,-137
35100,06,005,37383,06005,2283
203171,06,007,226864,06007,23693
40554,06,009,45171,06009,4617
18804,06,011,21588,06011,2784
948816,06,013,1135127,06013,186311
27507,06,015,27540,06015,33
156299,06,017,185625,06017,29326
799407,06,019,979915,06019,180508
26453,06,021,28085,06021,1632
126518,06,023,136646,06023,10128
142361,06,025,180883,06025,38522
17945,06,027,18144,06027,199
661645,06,029,884788,06029,223143
129461,06,031,149785,06031,20324
58309,06,033,64116,06033,5807
33828,06,035,30870,06035,-2958
9519338,06,037,10137915,06037,618577
123109,06,039,154697,06039,31588
247289,06,041,260651,06041,13362
17130,06,043,17410,06043,280
86265,06,045,87628,06045,1363
210554,06,047,268672,06047,58118
9449,06,049,8795,06049,-654
12853,06,051,13981,06051,1128
401762,06,053,435232,06053,33470
124279,06,055,142166,06055,17887
92033,06,057,99107,06057,7074
2846289,06,059,3172532,06059,326243
248399,06,061,380531,06061,132132
20824,06,063,18627,06063,-2197
1545387,06,065,2387741,06065,842354
1223499,06,067,1514460,06067,290961
53234,06,069,59414,06069,6180
1709434,06,071,2140096,06071,430662
2813833,06,073,3317749,06073,503916
776733,06,075,870887,06075,94154
563598,06,077,733709,06077,170111
246681,06,079,282887,06079,36206
707161,06,081,764797,06081,57636
399347,06,083,446170,06083,46823
1682585,06,085,1919402,06085,236817
255602,06,087,274673,06087,19071
163256,06,089,179631,06089,16375
3555,06,091,2947,06091,-608
44301,06,093,43603,06093,-698
394542,06,095,440207,06095,45665
458614,06,097,503070,06097,44456
446997,06,099,541560,06099,94563
78930,06,101,96651,06101,17721
56039,06,103,63276,06103,7237
13022,06,105,12782,06105,-240
368021,06,107,460437,06107,92416
54501,06,109,53804,06109,-697
753197,06,111,849738,06111,96541
168660,06,113,215802,06113,47142
60219,06,115,75275,06115,15056
363857,08,001,498187,08001,134330
14966,08,003,16654,08003,1688
487967,08,005,637068,08005,149101
9898,08,007,12854,08007,2956
4517,08,009,3568,08009,-949
5998,08,011,5861,08011,-137
291288,08,013,322226,08013,30938
16242,08,015,19058,08015,2816
2231,08,017,1848,08017,-383
9322,08,019,9436,08019,114
8400,08,021,8129,08021,-271
3663,08,023,3721,08023,58
5518,08,025,5694,08025,176
3503,08,027,4602,08027,1099
27834,08,029,30442,08029,2608
554636,08,031,693060,08031,138424
1844,08,033,2056,08033,212
175766,08,035,328632,08035,152866
41659,08,037,53989,08037,12330
19872,08,039,25231,08039,5359
516929,08,041,688284,08041,171355
46145,08,043,47446,08043,1301
43791,08,045,58887,08045,15096
4757,08,047,5931,08047,1174
12442,08,049,15008,08049,2566
13956,08,051,16408,08051,2452
790,08,053,788,08053,-2
7862,08,055,6677,08055,-1185
1577,08,057,1357,08057,-220
527056,08,059,571837,08059,44781
1622,08,061,1373,08061,-249
8011,08,063,8195,08063,184
7812,08,065,7618,08065,-194
43941,08,067,55623,08067,11682
251494,08,069,339993,08069,88499
15207,08,071,14103,08071,-1104
6087,08,073,5643,08073,-444
20504,08,075,21919,08075,1415
116255,08,077,150083,08077,33828
831,08,079,732,08079,-99
13184,08,081,13109,08081,-75
23830,08,083,26999,08083,3169
33432,08,085,41471,08085,8039
27171,08,087,28274,08087,1103
20311,08,089,18295,08089,-2016
3742,08,091,4857,08091,1115
14523,08,093,17166,08093,2643
4480,08,095,4288,08095,-192
14872,08,097,17752,08097,2880
14483,08,099,11922,08099,-2561
141472,08,101,165123,08101,23651
5986,08,103,6545,08103,559
12413,08,105,11479,08105,-934
19690,08,107,24648,08107,4958
5917,08,109,6389,08109,472
558,08,111,694,08111,136
6594,08,113,8017,08113,1423
2747,08,115,2407,08115,-340
23548,08,117,30374,08117,6826
20555,08,119,24043,08119,3488
4926,08,121,4908,08121,-18
180936,08,123,294932,08123,113996
9841,08,125,10103,08125,262
882567,09,001,944177,09001,61610
857183,09,003,892389,09003,35206
182193,09,005,182571,09005,378
155071,09,007,163329,09007,8258
824008,09,009,856875,09009,32867
259088,09,011,269801,09011,10713
136364,09,013,151118,09013,14754
109091,09,015,116192,09015,7101
126697,10,001,174827,10001,48130
500265,10,003,556987,10003,56722
156638,10,005,220251,10005,63613
572059,11,001,681170,11001,109111
217955,12,001,263496,12001,45541
22259,12,003,27937,12003,5678
148217,12,005,183974,12005,35757
26088,12,007,26926,12007,838
476230,12,009,579130,12009,102900
1623018,12,011,1909632,12011,286614
13017,12,013,14423,12013,1406
141627,12,015,178465,12015,36838
118085,12,017,143621,12017,25536
140814,12,019,208311,12019,67497
251377,12,021,365136,12021,113759
56513,12,023,69299,12023,12786
32209,12,027,35800,12027,3591
13827,12,029,16300,12029,2473
778879,12,031,926255,12031,147376
294410,12,033,315187,12033,20777
49832,12,035,108310,12035,58478
11057,12,037,11901,12037,844
45087,12,039,46006,12039,919
14437,12,041,17212,12041,2775
10576,12,043,13970,12043,3394
13332,12,045,15990,12045,2658
13327,12,047,14361,12047,1034
26938,12,049,27360,12049,422
36210,12,051,39290,12051,3080
130802,12,053,182835,12053,52033
87366,12,055,100917,12055,13551
998948,12,057,1376238,12057,377290
18564,12,059,19487,12059,923
112947,12,061,151563,12061,38616
46755,12,063,48229,12063,1474
12902,12,065,13906,12065,1004
7022,12,067,8617,12067,1595
210528,12,069,335396,12069,124868
440888,12,071,722336,12071,281448
239452,12,073,287822,12073,48370
34450,12,075,39961,12075,5511
7021,12,077,8202,12077,1181
18733,12,079,18224,12079,-509
264002,12,081,375888,12081,111886
258916,12,083,349020,12083,90104
126731,12,085,158701,12085,31970
2253362,12,086,2712945,12086,459583
79589,12,087,79077,12087,-512
57663,12,089,80622,12089,22959
170498,12,091,201170,12091,30672
35910,12,093,40314,12093,4404
896344,12,095,1314367,12095,418023
172493,12,097,336015,12097,163522
1131184,12,099,1443810,12099,312626
344765,12,101,512368,12101,167603
921482,12,103,960730,12103,39248
483924,12,105,666149,12105,182225
70423,12,107,72277,12107,1854
123135,12,109,235087,12109,111952
192695,12,111,306507,12111,113812
117743,12,113,170497,12113,52754
325957,12,115,412569,12115,86612
365196,12,117,455479,12117,90283
53345,12,119,123996,12119,70651
34844,12,121,43794,12121,8950
19256,12,123,22175,12123,2919
13442,12,125,15142,12125,1700
443343,12,127,529364,12127,86021
22863,12,129,31893,12129,9030
40601,12,131,65889,12131,25288
20973,12,133,24569,12133,3596
17419,13,001,18428,13001,1009
7609,13,003,8273,13003,664
10103,13,005,11372,13005,1269
4074,13,007,3150,13007,-924
44700,13,009,45144,13009,444
14422,13,011,18397,13011,3975
46144,13,013,77126,13013,30982
76019,13,015,103807,13015,27788
17484,13,017,17243,13017,-241
16235,13,019,18993,13019,2758
153887,13,021,152760,13021,-1127
11666,13,023,12970,13023,1304
14629,13,025,18355,13025,3726
16450,13,027,15687,13027,-763
23417,13,029,36230,13029,12813
55983,13,031,74722,13031,18739
22243,13,033,22688,13033,445
19522,13,035,23817,13035,4295
6320,13,037,6324,13037,4
43664,13,039,53008,13039,9344
9577,13,043,10910,13043,1333
87268,13,045,116261,13045,28993
53282,13,047,66398,13047,13116
10282,13,049,12497,13049,2215
232048,13,051,289082,13051,57034
14882,13,053,10922,13053,-3960
25470,13,055,24824,13055,-646
141903,13,057,241689,13057,99786
101489,13,059,124707,13059,23218
3357,13,061,3020,13061,-337
236517,13,063,279462,13063,42945
6878,13,065,6829,13065,-49
607751,13,067,748150,13067,140399
37413,13,069,43012,13069,5599
42053,13,071,45708,13071,3655
89288,13,073,147450,13073,58162
15771,13,075,17167,13075,1396
89215,13,077,140526,13077,51311
12495,13,079,12322,13079,-173
21996,13,081,22721,13081,725
15154,13,083,16257,13083,1103
15999,13,085,23604,13085,7605
28240,13,087,26822,13087,-1418
665865,13,089,740321,13089,74456
19171,13,091,20563,13091,1392
11525,13,093,13763,13093,2238
96065,13,095,90017,13095,-6048
92174,13,097,142224,13097,50050
12354,13,099,10339,13099,-2015
3754,13,101,3962,13101,208
37535,13,103,58712,13103,21177
20511,13,105,19143,13105,-1368
21837,13,107,22635,13107,798
10495,13,109,10670,13109,175
19798,13,111,24900,13111,5102
91263,13,113,111627,13113,20364
90565,13,115,96560,13115,5995
98407,13,117,221009,13117,122602
20285,13,119,22320,13119,2035
816006,13,121,1023336,13121,207330
23456,13,123,29733,13123,6277
2556,13,125,3006,13125,450
67568,13,127,84502,13127,16934
44104,13,129,56904,13129,12800
23659,13,131,24808,13131,1149
14406,13,133,17003,13133,2597
588448,13,135,907135,13135,318687
35902,13,137,44246,13137,8344
139277,13,139,196637,13139,57360
10076,13,141,8640,13141,-1436
25690,13,143,29042,13143,3352
23695,13,145,33652,13145,9957
22997,13,147,25553,13147,2556
11012,13,149,11487,13149,475
119341,13,151,221768,13151,102427
110765,13,153,152122,13153,41357
9931,13,155,9422,13155,-509
41589,13,157,64615,13157,23026
11426,13,159,13654,13159,2228
12684,13,161,14877,13161,2193
17266,13,163,15916,13163,-1350
8575,13,165,8849,13165,274
8560,13,167,9505,13167,945
23639,13,169,28623,13169,4984
15912,13,171,18469,13171,2557
7241,13,173,10399,13173,3158
44874,13,175,47516,13175,2642
24757,13,177,29337,13177,4580
61610,13,179,62570,13179,960
8348,13,181,7828,13181,-520
10304,13,183,18437,13183,8133
92115,13,185,114628,13185,22513
21016,13,187,31445,13187,10429
21231,13,189,21490,13189,259
10847,13,191,13927,13191,3080
14074,13,193,13450,13193,-624
25730,13,195,28824,13195,3094
7144,13,197,8524,13197,1380
22534,13,199,21074,13199,-1460
6383,13,201,5926,13201,-457
23932,13,205,22459,13205,-1473
21757,13,207,27306,13207,5549
8270,13,209,9060,13209,790
15457,13,211,18170,13211,2713
36506,13,213,39315,13213,2809
186291,13,215,197485,13215,11194
62001,13,217,106999,13217,44998
26225,13,219,36838,13219,10613
12635,13,221,14921,13221,2286
81678,13,223,155825,13223,74147
23668,13,225,26655,13225,2987
22983,13,227,30832,13227,7849
15636,13,229,19171,13229,3535
13688,13,231,17941,13231,4253
38127,13,233,41776,13233,3649
9588,13,235,11251,13235,1663
18812,13,237,21477,13237,2665
2598,13,239,2335,13239,-263
15050,13,241,16559,13241,1509
7791,13,243,7177,13243,-614
199775,13,245,201647,13245,1872
70111,13,247,89355,13247,19244
3766,13,249,5098,13249,1332
15374,13,251,14044,13251,-1330
9369,13,253,8468,13253,-901
58417,13,255,64806,13255,6389
25435,13,257,25751,13257,316
5252,13,259,5705,13259,453
33200,13,261,30389,13261,-2811
6498,13,263,6171,13263,-327
2077,13,265,1593,13265,-484
22305,13,267,25092,13267,2787
8815,13,269,8232,13269,-583
11794,13,271,15965,13271,4171
10970,13,273,8967,13273,-2003
42737,13,275,45248,13275,2511
38407,13,277,40828,13277,2421
26067,13,279,27196,13279,1129
9319,13,281,11391,13281,2072
6854,13,283,6637,13283,-217
58779,13,285,70005,13285,11226
9504,13,287,8030,13287,-1474
10590,13,289,8171,13289,-2419
17289,13,291,22928,13291,5639
27597,13,293,26335,13293,-1262
61053,13,295,67896,13295,6843
60687,13,297,90184,13297,29497
35483,13,299,35738,13299,255
6336,13,301,5442,13301,-894
21176,13,303,20457,13303,-719
26565,13,305,30104,13305,3539
2390,13,307,2599,13307,209
6179,13,309,7978,13309,1799
19944,13,311,28884,13311,8940
83525,13,313,104589,13313,21064
8577,13,315,8761,13315,184
10687,13,317,9805,13317,-882
10220,13,319,9104,13319,-1116
21967,13,321,20748,13321,-1219
148677,15,001,198449,15001,49772
876156,15,003,992605,15003,116449
147,15,005,88,15005,-59
58463,15,007,72029,15007,13566
128094,15,009,165386,15009,37292
300904,16,001,444028,16001,143124
3476,16,003,3900,16003,424
75565,16,005,84377,16005,8812
6411,16,007,5945,16007,-466
9171,16,009,9092,16009,-79
41735,16,011,45201,16011,3466
18991,16,013,21791,16013,2800
6670,16,015,7124,16015,454
36835,16,017,42536,16017,5701
82522,16,019,112232,16019,29710
9871,16,021,11681,16021,1810
2899,16,023,2501,16023,-398
991,16,025,1072,16025,81
131441,16,027,211698,16027,80257
7304,16,029,6887,16029,-417
21416,16,031,23504,16031,2088
1022,16,033,860,16033,-162
8930,16,035,8497,16035,-433
4342,16,037,4096,16037,-246
29130,16,039,26018,16039,-3112
11329,16,041,13406,16041,2077
11819,16,043,12943,16043,1124
15181,16,045,17184,16045,2003
14155,16,047,15185,16047,1030
15511,16,049,16156,16049,645
19155,16,051,27839,16051,8684
18342,16,053,22994,16053,4652
108685,16,055,154311,16055,45626
34935,16,057,39196,16057,4261
7806,16,059,7723,16059,-83
3747,16,061,3853,16061,106
4044,16,063,5271,16063,1227
27467,16,065,39048,16065,11581
20174,16,067,20616,16067,442
37410,16,069,40369,16069,2959
4125,16,071,4343,16071,218
10644,16,073,11389,16073,745
20578,16,075,23026,16075,2448
7538,16,077,7654,16077,116
13771,16,079,12452,16079,-1319
5999,16,081,10960,16081,4961
64284,16,083,83514,16083,19230
7651,16,085,10496,16085,2845
9977,16,087,10172,16087,195
68277,17,001,66578,17001,-1699
9590,17,003,6478,17003,-3112
17633,17,005,16824,17005,-809
41786,17,007,53503,17007,11717
6950,17,009,6762,17009,-188
35503,17,011,33359,17011,-2144
5084,17,013,4894,17013,-190
16674,17,015,14539,17015,-2135
13695,17,017,12676,17017,-1019
179669,17,019,208419,17019,28750
35372,17,021,33309,17021,-2063
17008,17,023,15938,17023,-1070
14560,17,025,13300,17025,-1260
35535,17,027,37729,17027,2194
53196,17,029,52343,17029,-853
5376741,17,031,5203499,17031,-173242
20452,17,033,19308,17033,-1144
11253,17,035,10858,17035,-395
88969,17,037,104528,17037,15559
16798,17,039,16226,17039,-572
19922,17,041,19630,17041,-292
904161,17,043,929368,17043,25207
19704,17,045,17566,17045,-2138
6971,17,047,6523,17047,-448
34264,17,049,34386,17049,122
21802,17,051,21789,17051,-13
14241,17,053,13575,17053,-666
39018,17,055,39156,17055,138
38250,17,057,35536,17057,-2714
6445,17,059,5212,17059,-1233
14761,17,061,13093,17061,-1668
37535,17,063,50437,17063,12902
8621,17,065,8061,17065,-560
20121,17,067,18508,17067,-1613
4800,17,069,4024,17069,-776
8213,17,071,6869,17071,-1344
51020,17,073,49280,17073,-1740
31334,17,075,28334,17075,-3000
59612,17,077,58870,17077,-742
10117,17,079,9536,17079,-581
40045,17,081,38460,17081,-1585
21668,17,083,22025,17083,357
22289,17,085,21770,17085,-519
12878,17,087,12902,17087,24
404119,17,089,531715,17089,127596
103833,17,091,110008,17091,6175
54544,17,093,124695,17093,70151
55836,17,095,50938,17095,-4898
644356,17,097,703047,17097,58691
111509,17,099,110642,17099,-867
15452,17,101,16377,17101,925
36062,17,103,34251,17103,-1811
39678,17,105,36526,17105,-3152
31183,17,107,29527,17107,-1656
32913,17,109,30996,17109,-1917
260077,17,111,307004,17111,46927
150433,17,113,172418,17113,21985
114706,17,115,106550,17115,-8156
49019,17,117,45908,17117,-3111
258941,17,119,265759,17119,6818
41691,17,121,38140,17121,-3551
13180,17,123,11939,17123,-1241
16038,17,125,13507,17125,-2531
15161,17,127,14658,17127,-503
12486,17,129,12516,17129,30
16957,17,131,15730,17131,-1227
27619,17,133,34068,17133,6449
30652,17,135,28952,17135,-1700
36616,17,137,34277,17137,-2339
14287,17,139,14827,17139,540
51032,17,141,51273,17141,241
183433,17,143,185006,17143,1573
23094,17,145,21357,17145,-1737
16365,17,147,16560,17147,195
17384,17,149,15950,17149,-1434
4413,17,151,4157,17151,-256
7348,17,153,5619,17153,-1729
6086,17,155,5611,17155,-475
33893,17,157,32621,17157,-1272
16149,17,159,15930,17159,-219
149374,17,161,144784,17161,-4590
256082,17,163,262759,17163,6677
26733,17,165,24307,17165,-2426
188951,17,167,197499,17167,8548
7189,17,169,6923,17169,-266
5537,17,171,5053,17171,-484
22893,17,173,21717,17173,-1176
6332,17,175,5776,17175,-556
48979,17,177,45624,17177,-3355
128485,17,179,134385,17179,5900
18293,17,181,17212,17181,-1081
83919,17,183,78111,17183,-5808
12937,17,185,11492,17185,-1445
18735,17,187,17378,17187,-1357
15148,17,189,14154,17189,-994
17151,17,191,16396,17191,-755
15371,17,193,14292,17193,-1079
60653,17,195,56536,17195,-4117
502266,17,197,689529,17197,187263
61296,17,199,67560,17199,6264
278418,17,201,285873,17201,7455
35469,17,203,39140,17203,3671
33625,18,001,35232,18001,1607
331849,18,003,370404,18003,38555
71435,18,005,81402,18005,9967
9421,18,007,8650,18007,-771
14048,18,009,12149,18009,-1899
46107,18,011,64653,18011,18546
14957,18,013,14912,18013,-45
20165,18,015,19970,18015,-195
40930,18,017,37946,18017,-2984
96472,18,019,116031,18019,19559
26556,18,021,26309,18021,-247
33866,18,023,32457,18023,-1409
10743,18,025,10539,18025,-204
29820,18,027,32969,18027,3149
46109,18,029,49331,18029,3222
24555,18,031,26598,18031,2043
40285,18,033,42746,18033,2461
118769,18,035,115603,18035,-3166
39674,18,037,42552,18037,2878
182791,18,039,203781,18039,20990
25588,18,041,23331,18041,-2257
70823,18,043,76990,18043,6167
17954,18,045,16486,18045,-1468
22151,18,047,22715,18047,564
20511,18,049,20139,18049,-372
32500,18,051,33703,18051,1203
73403,18,053,66937,18053,-6466
33157,18,055,32211,18055,-946
182740,18,057,316373,18057,133633
55391,18,059,73717,18059,18326
34325,18,061,39826,18061,5501
104093,18,063,160610,18063,56517
48508,18,065,48521,18065,13
84964,18,067,82568,18067,-2396
38075,18,069,36400,18069,-1675
41335,18,071,44013,18071,2678
30043,18,073,33433,18073,3390
21806,18,075,21046,18075,-760
31705,18,077,32418,18077,713
27554,18,079,27758,18079,204
115209,18,081,151982,18081,36773
39256,18,083,37744,18083,-1512
74057,18,085,79092,18085,5035
34909,18,087,39110,18087,4201
484564,18,089,485846,18089,1282
110106,18,091,110015,18091,-91
45922,18,093,45518,18093,-404
133358,18,095,129296,18095,-4062
860454,18,097,941229,18097,80775
45128,18,099,46556,18099,1428
10369,18,101,10171,18101,-198
36082,18,103,35883,18103,-199
120563,18,105,145496,18105,24933
37629,18,107,38074,18107,445
66689,18,109,69698,18109,3009
14566,18,111,13924,18111,-642
46275,18,113,47638,18113,1363
5623,18,115,5932,18115,309
19306,18,117,19335,18117,29
21786,18,119,20840,18119,-946
17241,18,121,16800,18121,-441
18899,18,123,18966,18123,67
12837,18,125,12431,18125,-406
146798,18,127,167791,18127,20993
27061,18,129,25476,18129,-1585
13755,18,131,12660,18131,-1095
36019,18,133,37436,18133,1417
27401,18,135,25082,18135,-2319
26523,18,137,28846,18137,2323
18261,18,139,16649,18139,-1612
265559,18,141,269141,18141,3582
22960,18,143,23730,18143,770
43445,18,145,44324,18145,879
20391,18,147,20648,18147,257
23556,18,149,23009,18149,-547
33214,18,151,34116,18151,902
21751,18,153,20802,18153,-949
9065,18,155,10527,18155,1462
148955,18,157,188059,18157,39104
16577,18,159,15182,18159,-1395
7349,18,161,7212,18161,-137
171922,18,163,181721,18163,9799
16788,18,165,15645,18165,-1143
105848,18,167,107931,18167,2083
34960,18,169,31762,18169,-3198
8419,18,171,8166,18171,-253
52383,18,173,62498,18173,10115
27223,18,175,27670,18175,447
71097,18,177,66568,18177,-4529
27600,18,179,27949,18179,349
25267,18,181,23999,18181,-1268
30707,18,183,33449,18183,2742
8243,19,001,7092,19001,-1151
4482,19,003,3693,19003,-789
14675,19,005,13884,19005,-791
13721,19,007,12462,19007,-1259
6830,19,009,5678,19009,-1152
25308,19,011,25699,19011,391
128012,19,013,132904,19013,4892
26224,19,015,26532,19015,308
23325,19,017,24798,19017,1473
21093,19,019,20992,19019,-101
20411,19,021,20332,19021,-79
15305,19,023,14791,19023,-514
11115,19,025,9846,19025,-1269
21421,19,027,20437,19027,-984
14684,19,029,13157,19029,-1527
18187,19,031,18454,19031,267
46447,19,033,43070,19033,-3377
13035,19,035,11508,19035,-1527
13095,19,037,12023,19037,-1072
9133,19,039,9309,19039,176
17372,19,041,16333,19041,-1039
18678,19,043,17590,19043,-1088
50149,19,045,47309,19045,-2840
16942,19,047,16940,19047,-2
40750,19,049,84516,19049,43766
8541,19,051,8860,19051,319
8689,19,053,8141,19053,-548
18404,19,055,17327,19055,-1077
42351,19,057,39739,19057,-2612
16424,19,059,17243,19059,819
89143,19,061,97003,19061,7860
11027,19,063,9658,19063,-1369
22008,19,065,20054,19065,-1954
16900,19,067,15873,19067,-1027
10704,19,069,10170,19069,-534
8010,19,071,6950,19071,-1060
10366,19,073,9011,19073,-1355
12369,19,075,12313,19075,-56
11353,19,077,10625,19077,-728
16438,19,079,15076,19079,-1362
12100,19,081,10835,19081,-1265
18812,19,083,17226,19083,-1586
15666,19,085,14149,19085,-1517
20336,19,087,19773,19087,-563
9932,19,089,9332,19089,-600
10381,19,091,9487,19091,-894
7837,19,093,6985,19093,-852
15671,19,095,16311,19095,640
20296,19,097,19472,19097,-824
37213,19,099,36708,19099,-505
16181,19,101,18090,19101,1909
111006,19,103,146547,19103,35541
20221,19,105,20439,19105,218
11400,19,107,10119,19107,-1281
17163,19,109,15114,19109,-2049
38052,19,111,34615,19111,-3437
191701,19,113,221661,19113,29960
12183,19,115,11142,19115,-1041
9422,19,117,8647,19117,-775
11763,19,119,11754,19119,-9
14019,19,121,15848,19121,1829
22335,19,123,22181,19123,-154
32052,19,125,33189,19125,1137
39311,19,127,40312,19127,1001
14547,19,129,14972,19129,425
10874,19,131,10763,19131,-111
10020,19,133,8898,19133,-1122
8016,19,135,7870,19135,-146
11771,19,137,10225,19137,-1546
41722,19,139,42940,19139,1218
15102,19,141,14020,19141,-1082
7003,19,143,6064,19143,-939
16976,19,145,15391,19145,-1585
10147,19,147,9047,19147,-1100
24849,19,149,25200,19149,351
8662,19,151,6886,19151,-1776
374601,19,153,474045,19153,99444
87704,19,155,93582,19155,5878
18815,19,157,18533,19157,-282
5469,19,159,5068,19159,-401
11529,19,161,9876,19161,-1653
158668,19,163,172474,19163,13806
13173,19,165,11800,19165,-1373
31589,19,167,34898,19167,3309
79981,19,169,97090,19169,17109
18103,19,171,17319,19171,-784
6958,19,173,6216,19173,-742
12309,19,175,12420,19175,111
7809,19,177,7271,19177,-538
36051,19,179,34982,19179,-1069
40671,19,181,49691,19181,9020
20670,19,183,22281,19183,1611
6730,19,185,6452,19185,-278
40235,19,187,36769,19187,-3466
11723,19,189,10631,19189,-1092
21310,19,191,20561,19191,-749
103877,19,193,102779,19193,-1098
7909,19,195,7572,19195,-337
14334,19,197,12779,19197,-1555
14385,20,001,12714,20001,-1671
8110,20,003,7827,20003,-283
16774,20,005,16380,20005,-394
5307,20,007,4688,20007,-619
28205,20,009,26775,20009,-1430
15379,20,011,14617,20011,-762
10724,20,013,9684,20013,-1040
59482,20,015,67025,20015,7543
3030,20,017,2669,20017,-361
4359,20,019,3374,20019,-985
22605,20,021,20246,20021,-2359
3165,20,023,2661,20023,-504
2390,20,025,2072,20025,-318
8822,20,027,8143,20027,-679
10268,20,029,9150,20029,-1118
8865,20,031,8433,20031,-432
1967,20,033,1862,20033,-105
36291,20,035,35753,20035,-538
38242,20,037,39164,20037,922
3472,20,039,2832,20039,-640
19344,20,041,19064,20041,-280
8249,20,043,7664,20043,-585
99962,20,045,119440,20045,19478
3449,20,047,2938,20047,-511
3261,20,049,2547,20049,-714
27507,20,051,28893,20051,1386
6525,20,053,6328,20053,-197
40523,20,055,36722,20055,-3801
32458,20,057,33971,20057,1513
24784,20,059,25560,20059,776
27947,20,061,35586,20061,7639
3068,20,063,2589,20063,-479
2946,20,065,2564,20065,-382
7909,20,067,7646,20067,-263
5904,20,069,6034,20069,130
1534,20,071,1296,20071,-238
7673,20,073,6151,20073,-1522
2670,20,075,2536,20075,-134
6536,20,077,5685,20077,-851
32869,20,079,34913,20079,2044
4307,20,081,4006,20081,-301
2085,20,083,1870,20083,-215
12657,20,085,13291,20085,634
18426,20,087,18897,20087,471
3791,20,089,2901,20089,-890
451086,20,091,584451,20091,133365
4531,20,093,3917,20093,-614
8673,20,095,7467,20095,-1206
3278,20,097,2483,20097,-795
22835,20,099,20444,20099,-2391
2155,20,101,1636,20101,-519
68691,20,103,80204,20103,11513
3578,20,105,3073,20105,-505
9570,20,107,9558,20107,-12
3046,20,109,2831,20109,-215
35935,20,111,33510,20111,-2425
29554,20,113,28804,20113,-750
13361,20,115,12112,20115,-1249
10965,20,117,9836,20117,-1129
4631,20,119,4216,20119,-415
28351,20,121,32964,20121,4613
6932,20,123,6243,20123,-689
36252,20,125,32746,20125,-3506
6104,20,127,5573,20127,-531
3496,20,129,2848,20129,-648
10717,20,131,10241,20131,-476
16997,20,133,16146,20133,-851
3454,20,135,2962,20135,-492
5953,20,137,5493,20137,-460
16712,20,139,15843,20139,-869
4452,20,141,3642,20141,-810
6163,20,143,5920,20143,-243
7233,20,145,6743,20145,-490
6001,20,147,5428,20147,-573
18209,20,149,23661,20149,5452
9647,20,151,9584,20151,-63
2966,20,153,2549,20153,-417
64790,20,155,63220,20155,-1570
5835,20,157,4699,20157,-1136
10761,20,159,9831,20159,-930
62843,20,161,73343,20161,10500
5685,20,163,5076,20163,-609
3551,20,165,3058,20165,-493
7370,20,167,6988,20167,-382
53597,20,169,55142,20169,1545
5120,20,171,5032,20171,-88
452869,20,173,511995,20173,59126
22510,20,175,22709,20175,199
169871,20,177,178146,20177,8275
2813,20,179,2509,20179,-304
6760,20,181,5965,20181,-795
4536,20,183,3632,20183,-904
4789,20,185,4208,20185,-581
2406,20,187,2062,20187,-344
5463,20,189,5584,20189,121
25946,20,191,23272,20191,-2674
8180,20,193,7892,20193,-288
3319,20,195,2872,20195,-447
6885,20,197,6891,20197,6
1749,20,199,1497,20199,-252
6483,20,201,5546,20201,-937
2531,20,203,2112,20203,-419
10332,20,205,8723,20205,-1609
3788,20,207,3165,20207,-623
157882,20,209,163831,20209,5949
17244,21,001,19280,21001,2036
17800,21,003,20631,21003,2831
19111,21,005,22158,21005,3047
8286,21,007,8054,21007,-232
38033,21,009,43993,21009,5960
11085,21,011,12327,21011,1242
30060,21,013,27117,21013,-2943
85991,21,015,128536,21015,42545
19360,21,017,20030,21017,670
49752,21,019,48132,21019,-1620
27697,21,021,30018,21021,2321
8279,21,023,8400,21023,121
16100,21,025,13284,21025,-2816
18648,21,027,19961,21027,1313
61236,21,029,79151,21029,17915
13010,21,031,12845,21031,-165
13060,21,033,12568,21033,-492
34177,21,035,38437,21035,4260
88616,21,037,92211,21037,3595
5351,21,039,4855,21039,-496
10155,21,041,10679,21041,524
26889,21,043,27046,21043,157
15447,21,045,15815,21045,368
72265,21,047,72351,21047,86
33144,21,049,35819,21049,2675
24556,21,051,20766,21051,-3790
9634,21,053,10177,21053,543
9384,21,055,9188,21055,-196
7147,21,057,6738,21057,-409
91545,21,059,99674,21059,8129
11644,21,061,12114,21061,470
6748,21,063,7588,21063,840
15307,21,065,14307,21065,-1000
260512,21,067,318449,21067,57937
13792,21,069,14507,21069,715
42441,21,071,37110,21071,-5331
47687,21,073,50560,21073,2873
7752,21,075,6179,21075,-1573
7870,21,077,8609,21077,739
14792,21,079,17292,21079,2500
22384,21,081,24923,21081,2539
37028,21,083,37182,21083,154
24053,21,085,26184,21085,2131
11518,21,087,11060,21087,-458
36891,21,089,35893,21089,-998
8392,21,091,8810,21091,418
94174,21,093,107316,21093,13142
33202,21,095,27168,21095,-6034
17983,21,097,18646,21097,663
17445,21,099,18627,21099,1182
44829,21,101,46253,21101,1424
15060,21,103,15818,21103,758
5262,21,105,4627,21105,-635
46519,21,107,45904,21107,-615
13495,21,109,13368,21109,-127
693604,21,111,765352,21111,71748
39041,21,113,52357,21113,13316
23445,21,115,22978,21115,-467
151464,21,117,164945,21117,13481
17649,21,119,15544,21119,-2105
31795,21,121,31687,21121,-108
13373,21,123,14096,21123,723
52715,21,125,60250,21125,7535
15569,21,127,15863,21127,294
7916,21,129,6580,21129,-1336
12401,21,131,10538,21131,-1863
25277,21,133,22773,21133,-2504
14092,21,135,13442,21135,-650
23361,21,137,24372,21137,1011
9804,21,139,9269,21139,-535
26573,21,141,26593,21141,20
8080,21,143,8069,21143,-11
65514,21,145,65162,21145,-352
17080,21,147,17511,21147,431
9938,21,149,9475,21149,-463
70872,21,151,89547,21151,18675
13332,21,153,12684,21153,-648
18212,21,155,19205,21155,993
30125,21,157,31365,21157,1240
12578,21,159,12002,21159,-576
16800,21,161,17190,21161,390
26349,21,163,28126,21163,1777
6556,21,165,6408,21165,-148
20817,21,167,21477,21167,660
10037,21,169,10018,21169,-19
11756,21,171,10588,21171,-1168
22554,21,173,27771,21173,5217
13948,21,175,13298,21175,-650
31839,21,177,31028,21177,-811
37477,21,179,45559,21179,8082
6813,21,181,7084,21181,271
22916,21,183,24378,21183,1462
46178,21,185,65560,21185,19382
10547,21,187,10642,21187,95
4858,21,189,4491,21189,-367
14390,21,191,14560,21191,170
29390,21,193,27343,21193,-2047
68736,21,195,60555,21195,-8181
13237,21,197,12308,21197,-929
56217,21,199,63956,21199,7739
2266,21,201,2155,21201,-111
16582,21,203,16850,21203,268
22094,21,205,24451,21205,2357
16315,21,207,17722,21207,1407
33061,21,209,53972,21209,20911
33337,21,211,46408,21211,13071
16405,21,213,18083,21213,1678
11766,21,215,18274,21215,6508
22927,21,217,25397,21217,2470
11971,21,219,12295,21219,324
12597,21,221,14264,21221,1667
8125,21,223,8620,21223,495
15637,21,225,14880,21225,-757
92522,21,227,125532,21227,33010
10916,21,229,12189,21229,1273
19923,21,231,20453,21231,530
14120,21,233,13316,21233,-804
35865,21,235,36096,21235,231
7065,21,237,7159,21237,94
23208,21,239,26124,21239,2916
58861,22,001,62645,22001,3784
25440,22,003,25684,22003,244
76627,22,005,121587,22005,44960
23388,22,007,22695,22007,-693
41481,22,009,41117,22009,-364
32986,22,011,36927,22011,3941
15752,22,013,13865,22013,-1887
98310,22,015,126057,22015,27747
252161,22,017,248851,22017,-3310
183577,22,019,200601,22019,17024
10560,22,021,10087,22021,-473
9991,22,023,6882,22023,-3109
10920,22,025,9921,22025,-999
16851,22,027,16132,22027,-719
20247,22,029,19920,22029,-327
25494,22,031,27149,22031,1655
412852,22,033,447037,22033,34185
9421,22,035,7271,22035,-2150
21360,22,037,19683,22037,-1677
35434,22,039,33709,22039,-1725
21263,22,041,20330,22041,-933
18698,22,043,22365,22043,3667
73266,22,045,73273,22045,7
33320,22,047,32920,22047,-400
15397,22,049,15808,22049,411
455466,22,051,436523,22051,-18943
31435,22,053,31413,22053,-22
190503,22,055,241398,22055,50895
89974,22,057,98305,22057,8331
14282,22,059,15052,22059,770
42509,22,061,47745,22061,5236
91814,22,063,140138,22063,48324
13728,22,065,11528,22065,-2200
31021,22,067,26071,22067,-4950
39080,22,069,39162,22069,82
484674,22,071,391495,22071,-93179
147250,22,073,156983,22073,9733
26757,22,075,23464,22075,-3293
22763,22,077,22159,22077,-604
126337,22,079,132424,22079,6087
9622,22,081,8550,22081,-1072
20981,22,083,20430,22083,-551
23459,22,085,23977,22085,518
67229,22,087,45688,22087,-21541
48072,22,089,52923,22089,4851
10525,22,091,10512,22091,-13
21216,22,093,21557,22093,341
43044,22,095,43631,22095,587
87700,22,097,83883,22097,-3817
48583,22,099,54007,22099,5424
53500,22,101,52093,22101,-1407
191268,22,103,253602,22103,62334
100588,22,105,130710,22105,30122
6618,22,107,4597,22107,-2021
104503,22,109,113220,22109,8717
22803,22,111,22487,22111,-316
53807,22,113,60205,22113,6398
52531,22,115,50569,22115,-1962
43926,22,117,46310,22117,2384
41831,22,119,39710,22119,-2121
21601,22,121,25795,22121,4194
12314,22,123,11114,22123,-1200
15111,22,125,15344,22125,233
16894,22,127,14376,22127,-2518
103793,23,001,107319,23001,3526
73938,23,003,67959,23003,-5979
265612,23,005,292041,23005,26429
29467,23,007,30001,23007,534
51791,23,009,54419,23009,2628
117114,23,011,120569,23011,3455
39618,23,013,39744,23013,126
33616,23,015,34216,23015,600
54755,23,017,57217,23017,2462
144919,23,019,151806,23019,6887
17235,23,021,16843,23021,-392
35214,23,023,35273,23023,59
50888,23,025,50915,23025,27
36280,23,027,39364,23027,3084
33941,23,029,31450,23029,-2491
186742,23,031,202343,23031,15601
74930,24,001,72130,24001,-2800
489656,24,003,568346,24003,78690
754292,24,005,831026,24005,76734
74563,24,009,91251,24009,16688
29772,24,011,32850,24011,3078
150897,24,013,167656,24013,16759
85951,24,015,102603,24015,16652
120546,24,017,157705,24017,37159
30674,24,019,32258,24019,1584
195277,24,021,247591,24021,52314
29846,24,023,29425,24023,-421
218590,24,025,251032,24025,32442
247842,24,027,317233,24027,69391
19197,24,029,19730,24029,533
873341,24,031,1043863,24031,170522
801515,24,033,908049,24033,106534
40563,24,035,48929,24035,8366
86211,24,037,112587,24037,26376
24747,24,039,25928,24039,1181
33812,24,041,37278,24041,3466
131923,24,043,150292,24043,18369
84644,24,045,102577,24045,17933
46543,24,047,51444,24047,4901
651154,24,510,614664,24510,-36490
222230,25,001,214276,25001,-7954
134953,25,003,126903,25003,-8050
534678,25,005,558324,25005,23646
14987,25,007,17246,25007,2259
723419,25,009,779018,25009,55599
71535,25,011,70382,25011,-1153
456228,25,013,468467,25013,12239
152251,25,015,161816,25015,9565
1465396,25,017,1589774,25017,124378
9520,25,019,11008,25019,1488
650308,25,021,697181,25021,46873
472822,25,023,513565,25023,40743
689807,25,025,784230,25025,94423
750963,25,027,819589,25027,68626
11719,26,001,10352,26001,-1367
9862,26,003,9219,26003,-643
105665,26,005,115548,26005,9883
31314,26,007,28704,26007,-2610
23110,26,009,23144,26009,34
17269,26,011,15122,26011,-2147
8746,26,013,8503,26013,-243
56755,26,015,59702,26015,2947
110157,26,017,104747,26017,-5410
15998,26,019,17572,26019,1574
162453,26,021,154010,26021,-8443
45787,26,023,43427,26023,-2360
137985,26,025,134386,26025,-3599
51104,26,027,51599,26027,495
26090,26,029,26174,26029,84
26448,26,031,25401,26031,-1047
38543,26,033,37724,26033,-819
31252,26,035,30358,26035,-894
64753,26,037,77888,26037,13135
14273,26,039,13744,26039,-529
38520,26,041,36202,26041,-2318
27472,26,043,25535,26043,-1937
103655,26,045,109160,26045,5505
31437,26,047,33182,26047,1745
436141,26,049,408615,26049,-27526
26023,26,051,25122,26051,-901
17370,26,053,15243,26053,-2127
77654,26,055,92084,26055,14430
42285,26,057,41202,26057,-1083
46527,26,059,45774,26059,-753
36016,26,061,36555,26061,539
36079,26,063,31481,26063,-4598
279320,26,065,288051,26065,8731
61518,26,067,64232,26067,2714
27339,26,069,25327,26069,-2012
13138,26,071,11195,26071,-1943
63351,26,073,71282,26073,7931
158422,26,075,158460,26075,38
238603,26,077,261654,26077,23051
16571,26,079,17263,26079,692
574335,26,081,642173,26081,67838
2301,26,083,2199,26083,-102
11333,26,085,11496,26085,163
87904,26,087,88340,26087,436
21119,26,089,21765,26089,646
98890,26,091,98504,26091,-386
156951,26,093,188624,26093,31673
7024,26,095,6358,26095,-666
11943,26,097,10820,26097,-1123
788149,26,099,867730,26099,79581
24527,26,101,24373,26101,-154
64634,26,103,66435,26103,1801
28274,26,105,28876,26105,602
40553,26,107,43221,26107,2668
25326,26,109,23281,26109,-2045
82874,26,111,83462,26111,588
14478,26,113,15102,26113,624
145945,26,115,149208,26115,3263
61266,26,117,62974,26117,1708
10315,26,119,9173,26119,-1142
170200,26,121,173408,26121,3208
47874,26,123,47938,26123,64
1194156,26,125,1243970,26125,49814
26873,26,127,26027,26127,-846
21645,26,129,20904,26129,-741
7818,26,131,5911,26131,-1907
23197,26,133,23110,26133,-87
9418,26,135,8264,26135,-1154
23301,26,137,24470,26137,1169
238314,26,139,282250,26139,43936
14411,26,141,12762,26141,-1649
25469,26,143,23700,26143,-1769
210039,26,145,192326,26145,-17713
164235,26,147,159587,26147,-4648
62422,26,149,60853,26149,-1569
44547,26,151,41409,26151,-3138
8903,26,153,8001,26153,-902
71687,26,155,68554,26155,-3133
58266,26,157,53338,26157,-4928
76263,26,159,75223,26159,-1040
322895,26,161,364709,26161,41814
2061162,26,163,1749366,26163,-311796
30484,26,165,33163,26165,2679
15301,27,001,15583,27001,282
298084,27,003,345957,27003,47873
30000,27,005,33734,27005,3734
39650,27,007,46106,27007,6456
34226,27,009,39992,27009,5766
5820,27,011,5050,27011,-770
55941,27,013,66441,27013,10500
26911,27,015,25331,27015,-1580
31671,27,017,35738,27017,4067
70205,27,019,100262,27019,30057
27150,27,021,28993,27021,1843
13088,27,023,12133,27023,-955
41101,27,025,54748,27025,13647
51229,27,027,62875,27027,11646
8423,27,029,8827,27029,404
5168,27,031,5286,27031,118
12167,27,033,11470,27033,-697
55099,27,035,63940,27035,8841
355904,27,037,417486,27037,61582
17731,27,039,20506,27039,2775
32821,27,041,37456,27041,4635
16181,27,043,13935,27043,-2246
21122,27,045,21003,27045,-119
32584,27,047,30446,27047,-2138
44127,27,049,46676,27049,2549
6289,27,051,5956,27051,-333
1116200,27,053,1232483,27053,116283
19718,27,055,18814,27055,-904
18376,27,057,20718,27057,2342
31287,27,059,39025,27059,7738
43992,27,061,45242,27061,1250
11268,27,063,9944,27063,-1324
14996,27,065,15830,27065,834
41203,27,067,42495,27067,1292
5285,27,069,4333,27069,-952
14355,27,071,12628,27071,-1727
8067,27,073,6715,27073,-1352
11058,27,075,10625,27075,-433
4522,27,077,3814,27077,-708
25426,27,079,27591,27079,2165
6429,27,081,5783,27081,-646
25425,27,083,25699,27083,274
34898,27,085,35842,27085,944
5190,27,087,5465,27087,275
10155,27,089,9324,27089,-831
21802,27,091,19829,27091,-1973
22644,27,093,23110,27093,466
22330,27,095,25866,27095,3536
31712,27,097,32821,27097,1109
38603,27,099,39163,27099,560
9165,27,101,8329,27101,-836
29771,27,103,33575,27103,3804
20832,27,105,21848,27105,1016
7442,27,107,6579,27107,-863
124277,27,109,153102,27109,28825
57159,27,111,58085,27111,926
13584,27,113,14235,27113,651
26530,27,115,28874,27115,2344
9895,27,117,9202,27117,-693
31369,27,119,31660,27119,291
11236,27,121,11049,27121,-187
511035,27,123,540649,27123,29614
4299,27,125,4007,27125,-292
16815,27,127,15263,27127,-1552
17154,27,129,14660,27129,-2494
56665,27,131,65622,27131,8957
9721,27,133,9564,27133,-157
16338,27,135,15626,27135,-712
200528,27,137,199980,27137,-548
89498,27,139,143680,27139,54182
64417,27,141,93528,27141,29111
15356,27,143,14827,27143,-529
133166,27,145,155652,27145,22486
33680,27,147,36805,27147,3125
10053,27,149,9693,27149,-360
11956,27,151,9419,27151,-2537
24426,27,153,24233,27153,-193
4134,27,155,3356,27155,-778
21610,27,157,21273,27157,-337
13713,27,159,13761,27159,48
19526,27,161,18911,27161,-615
201130,27,163,253117,27163,51987
11876,27,165,10908,27165,-968
7138,27,167,6358,27167,-780
49985,27,169,50948,27169,963
89986,27,171,132550,27171,42564
11080,27,173,9935,27173,-1145
34340,28,001,31248,28001,-3092
34558,28,003,37304,28003,2746
13599,28,005,12458,28005,-1141
19661,28,007,18934,28007,-727
8026,28,009,8264,28009,238
40633,28,011,32737,28011,-7896
15069,28,013,14610,28013,-459
10769,28,015,10255,28015,-514
19440,28,017,17246,28017,-2194
9758,28,019,8242,28019,-1516
11831,28,021,9139,28021,-2692
17955,28,023,15888,28023,-2067
21979,28,025,19850,28025,-2129
30622,28,027,23809,28027,-6813
28757,28,029,28482,28029,-275
19407,28,031,19569,28031,162
107199,28,033,175611,28033,68412
72604,28,035,75979,28035,3375
8448,28,037,7782,28037,-666
19144,28,039,23695,28039,4551
13299,28,041,13408,28041,109
23263,28,043,21275,28043,-1988
42967,28,045,46791,28045,3824
189601,28,047,203234,28047,13633
250800,28,049,241229,28049,-9571
21609,28,051,17999,28051,-3610
11206,28,053,8513,28053,-2693
2274,28,055,1294,28055,-980
22770,28,057,23529,28057,759
131420,28,059,141241,28059,9821
18149,28,061,16578,28061,-1571
9740,28,063,7297,28063,-2443
13962,28,065,11385,28065,-2577
64958,28,067,67953,28067,2995
10453,28,069,9896,28069,-557
38744,28,071,53796,28071,15052
39070,28,073,60914,28073,21844
78161,28,075,77755,28075,-406
13258,28,077,12749,28077,-509
20940,28,079,22620,28079,1680
75755,28,081,85381,28081,9626
37947,28,083,29856,28083,-8091
33166,28,085,34523,28085,1357
61586,28,087,59602,28087,-1984
74674,28,089,105114,28089,30440
25595,28,091,25251,28091,-344
34993,28,093,35801,28093,808
38014,28,095,35873,28095,-2141
12189,28,097,10187,28097,-2002
28684,28,099,29403,28099,719
21838,28,101,21558,28101,-280
12548,28,103,11038,28103,-1510
42902,28,105,49833,28105,6931
34274,28,107,34164,28107,-110
48621,28,109,55310,28109,6689
12138,28,111,12245,28111,107
38940,28,113,39667,28113,727
26726,28,115,31550,28115,4824
25556,28,117,25256,28117,-300
10117,28,119,7349,28119,-2768
115327,28,121,150228,28121,34901
28423,28,123,28207,28123,-216
6580,28,125,4552,28125,-2028
27639,28,127,26912,28127,-727
16182,28,129,15909,28129,-273
13622,28,131,18012,28131,4390
34369,28,133,26407,28133,-7962
14903,28,135,14394,28135,-509
25370,28,137,28201,28137,2831
20826,28,139,22190,28139,1364
19163,28,141,19491,28141,328
9227,28,143,10234,28143,1007
25362,28,145,28311,28145,2949
15156,28,147,14599,28147,-557
49644,28,149,47140,28149,-2504
62977,28,151,47231,28151,-15746
21216,28,153,20480,28153,-736
10294,28,155,9767,28155,-527
10312,28,157,9047,28157,-1265
20160,28,159,18160,28159,-2000
13051,28,161,12471,28161,-580
28149,28,163,27264,28163,-885
24977,29,001,25359,29001,382
16492,29,003,17350,29003,858
6430,29,005,5293,29005,-1137
25853,29,007,26021,29007,168
34010,29,009,35732,29009,1722
12541,29,011,11908,29011,-633
16653,29,013,16417,29013,-236
17180,29,015,18839,29015,1659
12029,29,017,12052,29017,23
135454,29,019,176594,29019,41140
85998,29,021,88938,29021,2940
40867,29,023,42739,29023,1872
8969,29,025,9062,29025,93
40766,29,027,45078,29027,4312
37051,29,029,44497,29029,7446
68693,29,031,78913,29031,10220
10285,29,033,8913,29033,-1372
5941,29,035,6168,29035,227
82092,29,037,102845,29037,20753
13733,29,039,14016,29039,283
8438,29,041,7516,29041,-922
54285,29,043,84401,29043,30116
7416,29,045,6723,29045,-693
184006,29,047,239085,29047,55079
18979,29,049,20610,29049,1631
71397,29,051,76631,29051,5234
16670,29,053,17712,29053,1042
22804,29,055,24302,29055,1498
7923,29,057,7631,29057,-292
15661,29,059,16448,29059,787
8016,29,061,8209,29061,193
11597,29,063,12613,29063,1016
14927,29,065,15387,29065,460
13084,29,067,13358,29067,274
33155,29,069,30535,29069,-2620
93807,29,071,102838,29071,9031
15342,29,073,14808,29073,-534
6861,29,075,6661,29075,-200
240391,29,077,288690,29077,48299
10432,29,079,10165,29079,-267
8850,29,081,8556,29081,-294
21997,29,083,21594,29083,-403
8940,29,085,9269,29085,329
5351,29,087,4448,29087,-903
10212,29,089,10058,29089,-154
37238,29,091,40210,29091,2972
10697,29,093,10022,29093,-675
654880,29,095,691801,29095,36921
104686,29,097,119111,29097,14425
198099,29,099,224226,29099,26127
48258,29,101,53942,29101,5684
4361,29,103,3934,29103,-427
32513,29,105,35490,29105,2977
32960,29,107,32618,29107,-342
35204,29,109,38381,29109,3177
10494,29,111,10134,29111,-360
38944,29,113,55267,29113,16323
13754,29,115,12164,29115,-1590
14558,29,117,15235,29117,677
21681,29,119,22620,29119,939
15762,29,121,15170,29121,-592
11800,29,123,12443,29123,643
8903,29,125,8858,29125,-45
28289,29,127,28894,29127,605
3757,29,129,3699,29129,-58
23564,29,131,25206,29131,1642
13427,29,133,13799,29133,372
14827,29,135,16018,29135,1191
9311,29,137,8558,29137,-753
12136,29,139,11620,29139,-516
19309,29,141,20213,29141,904
19760,29,143,17915,29143,-1845
52636,29,145,58694,29145,6058
21912,29,147,22670,29147,758
10344,29,149,10789,29149,445
13062,29,151,13664,29151,602
9542,29,153,9237,29153,-305
20047,29,155,17073,29155,-2974
18132,29,157,19285,29157,1153
39403,29,159,42213,29159,2810
39825,29,161,44608,29161,4783
18351,29,163,18438,29163,87
73781,29,165,98309,29165,24528
26992,29,167,31285,29167,4293
41165,29,169,52654,29169,11489
5223,29,171,4853,29171,-370
9626,29,173,10224,29173,598
24663,29,175,24989,29175,326
23354,29,177,22754,29177,-600
6689,29,179,6455,29179,-234
13509,29,181,13817,29181,308
283883,29,183,390918,29183,107035
9652,29,185,9272,29185,-380
17842,29,186,18030,29186,188
55641,29,187,66627,29187,10986
1016315,29,189,998581,29189,-17734
23756,29,195,22980,29195,-776
4170,29,197,4394,29197,224
4983,29,199,4932,29199,-51
40422,29,201,38745,29201,-1677
8324,29,203,8168,29203,-156
6799,29,205,6082,29205,-717
29705,29,207,29588,29207,-117
28658,29,209,31047,29209,2389
7219,29,211,6262,29211,-957
39703,29,213,54735,29213,15032
23003,29,215,25775,29215,2772
20454,29,217,20723,29217,269
24525,29,219,33802,29219,9277
23344,29,221,24839,29221,1495
13259,29,223,13139,29223,-120
31045,29,225,38106,29225,7061
2382,29,227,2024,29227,-358
17955,29,229,18286,29229,331
348189,29,510,311404,29510,-36785
9202,30,001,9401,30001,199
12671,30,003,13343,30003,672
7009,30,005,6601,30005,-408
4385,30,007,5747,30007,1362
9552,30,009,10460,30009,908
1360,30,011,1203,30011,-157
80357,30,013,81755,30013,1398
5970,30,015,5759,30015,-211
11696,30,017,11924,30017,228
2017,30,019,1755,30019,-262
9059,30,021,9327,30021,268
9417,30,023,9085,30023,-332
2837,30,025,3120,30025,283
11893,30,027,11413,30027,-480
74471,30,029,98082,30029,23611
67831,30,031,104502,30031,36671
1279,30,033,1310,30033,31
13247,30,035,13694,30035,447
1042,30,037,831,30037,-211
2830,30,039,3368,30039,538
16673,30,041,16542,30041,-131
10049,30,043,11853,30043,1804
2329,30,045,1940,30045,-389
26507,30,047,29758,30047,3251
55716,30,049,67282,30049,11566
2158,30,051,2409,30051,251
18837,30,053,19259,30053,422
1977,30,055,1700,30055,-277
6851,30,057,7924,30057,1073
1932,30,059,1827,30059,-105
3884,30,061,4184,30061,300
95802,30,063,116130,30063,20328
4497,30,065,4589,30065,92
15694,30,067,16114,30067,420
493,30,069,489,30069,-4
4601,30,071,4133,30071,-468
6424,30,073,6084,30073,-340
1858,30,075,1746,30075,-112
7180,30,077,6858,30077,-322
1199,30,079,1182,30079,-17
36070,30,081,42088,30081,6018
9667,30,083,11482,30083,1815
10620,30,085,11305,30085,685
9383,30,087,9287,30087,-96
10227,30,089,11534,30089,1307
4105,30,091,3648,30091,-457
34606,30,093,34553,30093,-53
8195,30,095,9406,30095,1211
3609,30,097,3623,30097,14
6445,30,099,6056,30099,-389
5267,30,101,4977,30101,-290
861,30,103,692,30103,-169
7675,30,105,7539,30105,-136
2259,30,107,2117,30107,-142
1068,30,109,1093,30109,25
129352,30,111,158437,30111,29085
31151,31,001,31684,31001,533
7452,31,003,6329,31003,-1123
444,31,005,469,31005,25
819,31,007,798,31007,-21
583,31,009,484,31009,-99
6259,31,011,5332,31011,-927
12158,31,013,11194,31013,-964
2438,31,015,1982,31015,-456
3525,31,017,2960,31017,-565
42259,31,019,49383,31019,7124
7791,31,021,6546,31021,-1245
8767,31,023,8052,31023,-715
24334,31,025,25767,31025,1433
9615,31,027,8671,31027,-944
4068,31,029,3937,31029,-131
6148,31,031,5832,31031,-316
9830,31,033,10051,31033,221
7039,31,035,6163,31035,-876
10441,31,037,10414,31037,-27
10203,31,039,9016,31039,-1187
11793,31,041,10807,31041,-986
20253,31,043,20465,31043,212
9060,31,045,8979,31045,-81
24365,31,047,23640,31047,-725
2098,31,049,1873,31049,-225
6339,31,051,5762,31051,-577
36160,31,053,36757,31053,597
463585,31,055,554995,31055,91410
2292,31,057,1831,31057,-461
6634,31,059,5720,31059,-914
3574,31,061,3014,31061,-560
3099,31,063,2621,31063,-478
5324,31,065,4787,31065,-537
22993,31,067,21799,31067,-1194
2292,31,069,1930,31069,-362
1902,31,071,2011,31071,109
2143,31,073,1971,31073,-172
747,31,075,641,31075,-106
2714,31,077,2399,31077,-315
53534,31,079,61705,31079,8171
9403,31,081,9186,31081,-217
3786,31,083,3473,31083,-313
1068,31,085,897,31085,-171
3111,31,087,2825,31087,-286
11551,31,089,10250,31089,-1301
783,31,091,708,31091,-75
6567,31,093,6429,31093,-138
8333,31,095,7177,31095,-1156
4488,31,097,5171,31097,683
6882,31,099,6552,31099,-330
8875,31,101,8018,31101,-857
983,31,103,791,31103,-192
4089,31,105,3679,31105,-410
9374,31,107,8571,31107,-803
250291,31,109,309637,31109,59346
34632,31,111,35550,31111,918
774,31,113,772,31113,-2
712,31,115,591,31115,-121
533,31,117,493,31117,-40
35226,31,119,35015,31119,-211
8204,31,121,7828,31121,-376
5440,31,123,4787,31123,-653
4038,31,125,3576,31125,-462
7576,31,127,6971,31127,-605
5057,31,129,4265,31129,-792
15396,31,131,16081,31131,685
3087,31,133,2652,31133,-435
3200,31,135,2898,31135,-302
9747,31,137,9266,31137,-481
7857,31,139,7159,31139,-698
31662,31,141,32861,31141,1199
5639,31,143,5203,31143,-436
11448,31,145,10722,31145,-726
9531,31,147,8060,31147,-1471
1756,31,149,1390,31149,-366
13843,31,151,14331,31151,488
122595,31,153,179023,31153,56428
19830,31,155,21038,31155,1208
36951,31,157,36422,31157,-529
16496,31,159,17284,31159,788
6198,31,161,5234,31161,-964
3318,31,163,3054,31163,-264
1475,31,165,1242,31165,-233
6455,31,167,5944,31167,-511
6055,31,169,5101,31169,-954
729,31,171,716,31171,-13
7171,31,173,7127,31173,-44
4647,31,175,4184,31175,-463
18780,31,177,20603,31177,1823
9851,31,179,9365,31179,-486
4061,31,181,3603,31181,-458
886,31,183,776,31183,-110
14598,31,185,13794,31185,-804
23982,32,001,24198,32001,216
1375765,32,003,2155664,32003,779899
41259,32,005,48020,32005,6761
45291,32,007,52168,32007,6877
971,32,009,790,32009,-181
1651,32,011,1917,32011,266
16106,32,013,16842,32013,736
5794,32,015,5702,32015,-92
4165,32,017,5055,32017,890
34501,32,019,53179,32019,18678
5071,32,021,4449,32021,-622
32485,32,023,43423,32023,10938
6693,32,027,6560,32027,-133
3399,32,029,4051,32029,652
339486,32,031,453616,32031,114130
9181,32,033,9682,32033,501
52457,32,510,54742,32510,2285
56325,33,001,60779,33001,4454
43666,33,003,47289,33003,3623
73825,33,005,75774,33005,1949
33111,33,007,32039,33007,-1072
81743,33,009,88888,33009,7145
380841,33,011,407761,33011,26920
136225,33,013,148582,33013,12357
277359,33,015,303251,33015,25892
112233,33,017,127428,33017,15195
40458,33,019,43004,33019,2546
252552,34,001,270991,34001,18439
884118,34,003,939151,34003,55033
423394,34,005,449284,34005,25890
508932,34,007,510150,34007,1218
102326,34,009,94430,34009,-7896
146438,34,011,153797,34011,7359
793633,34,013,796914,34013,3281
254673,34,015,292330,34015,37657
608975,34,017,677983,34017,69008
121989,34,019,124676,34019,2687
350761,34,021,371023,34021,20262
750162,34,023,837073,34023,86911
615301,34,025,625846,34025,10545
470212,34,027,498423,34027,28211
510916,34,029,592497,34029,81581
489049,34,031,507945,34031,18896
64285,34,033,63436,34033,-849
297490,34,035,333751,34035,36261
144166,34,037,142522,34037,-1644
522541,34,039,555630,34039,33089
102437,34,041,106617,34041,4180
556678,35,001,676953,35001,120275
3543,35,003,3508,35003,-35
61382,35,005,65282,35005,3900
25595,35,006,27487,35006,1892
14189,35,007,12253,35007,-1936
45044,35,009,50280,35009,5236
2240,35,011,1793,35011,-447
174682,35,013,214207,35013,39525
51658,35,015,57621,35015,5963
31002,35,017,28280,35017,-2722
4680,35,019,4376,35019,-304
810,35,021,665,35021,-145
5932,35,023,4302,35023,-1630
55511,35,025,69749,35025,14238
19411,35,027,19429,35027,18
18343,35,028,18147,35028,-196
25016,35,029,24450,35029,-566
74798,35,031,74923,35031,125
5180,35,033,4504,35033,-676
62298,35,035,65410,35035,3112
10155,35,037,8365,35037,-1790
41190,35,039,40040,35039,-1150
18018,35,041,19082,35041,1064
89908,35,043,142025,35043,52117
113801,35,045,115079,35045,1278
30126,35,047,27760,35047,-2366
129292,35,049,148651,35049,19359
13270,35,051,11191,35051,-2079
18078,35,053,17027,35053,-1051
29979,35,055,33065,35055,3086
16911,35,057,15302,35057,-1609
4174,35,059,4183,35059,9
66152,35,061,75626,35061,9474
294565,36,001,308846,36001,14281
49927,36,003,47077,36003,-2850
1332650,36,005,1455720,36005,123070
200536,36,007,195334,36007,-5202
83955,36,009,77677,36009,-6278
81963,36,011,77861,36011,-4102
139750,36,013,129504,36013,-10246
91070,36,015,86322,36015,-4748
51401,36,017,48579,36017,-2822
79894,36,019,81073,36019,1179
63094,36,021,60989,36021,-2105
48599,36,023,48070,36023,-529
48055,36,025,45523,36025,-2532
280150,36,027,294473,36027,14323
950265,36,029,921046,36029,-29219
38851,36,031,38102,36031,-749
51134,36,033,50409,36033,-725
55073,36,035,53828,36035,-1245
60370,36,037,58482,36037,-1888
48195,36,039,47508,36039,-687
5379,36,041,4542,36041,-837
64427,36,043,62613,36043,-1814
111738,36,045,114006,36045,2268
2465326,36,047,2629150,36047,163824
26944,36,049,26865,36049,-79
64328,36,051,64257,36051,-71
69441,36,053,71329,36053,1888
735343,36,055,747727,36055,12384
49708,36,057,49276,36057,-432
1334544,36,059,1361500,36059,26956
1537195,36,061,1643734,36061,106539
219846,36,063,211758,36063,-8088
235469,36,065,231190,36065,-4279
458336,36,067,466194,36067,7858
100224,36,069,109828,36069,9604
341367,36,071,379210,36071,37843
44171,36,073,41346,36073,-2825
122377,36,075,118987,36075,-3390
61676,36,077,60097,36077,-1579
95745,36,079,98900,36079,3155
2229379,36,081,2333054,36081,103675
152538,36,083,160070,36083,7532
443728,36,085,476015,36085,32287
286753,36,087,326780,36087,40027
111931,36,089,110038,36089,-1893
200635,36,091,227053,36091,26418
146555,36,093,154553,36093,7998
31582,36,095,31317,36095,-265
19224,36,097,18099,36097,-1125
33342,36,099,34777,36099,1435
98726,36,101,96940,36101,-1786
1419369,36,103,1492583,36103,73214
73966,36,105,74801,36105,835
51784,36,107,48760,36107,-3024
96501,36,109,104871,36109,8370
177749,36,111,179225,36111,1476
63303,36,113,64567,36113,1264
61042,36,115,61800,36115,758
93765,36,117,90798,36117,-2967
923459,36,119,974542,36119,51083
43424,36,121,40791,36121,-2633
24621,36,123,24923,36123,302
130800,37,001,159688,37001,28888
33603,37,003,37428,37003,3825
10677,37,005,10848,37005,171
25275,37,007,25448,37007,173
24384,37,009,26924,37009,2540
17167,37,011,17516,37011,349
44958,37,013,47526,37013,2568
19773,37,015,19854,37015,81
32278,37,017,33741,37017,1463
73143,37,019,126953,37019,53810
206330,37,021,256088,37021,49758
89148,37,023,88851,37023,-297
131063,37,025,201590,37025,70527
77415,37,027,81449,37027,4034
6885,37,029,10418,37029,3533
59383,37,031,68890,37031,9507
23501,37,033,22910,37033,-591
141685,37,035,156459,37035,14774
49329,37,037,72243,37037,22914
24298,37,039,27905,37039,3607
14526,37,041,14383,37041,-143
8775,37,043,10915,37043,2140
96287,37,045,97144,37045,857
54749,37,047,56505,37047,1756
91436,37,049,103445,37049,12009
302963,37,051,327127,37051,24164
18190,37,053,25809,37053,7619
29967,37,055,35964,37055,5997
147246,37,057,164926,37057,17680
34835,37,059,42013,37059,7178
49063,37,061,58969,37061,9906
223314,37,063,306212,37063,82898
55606,37,065,53318,37065,-2288
306067,37,067,371511,37067,65444
47260,37,069,64705,37069,17445
190365,37,071,216965,37071,26600
10516,37,073,11478,37073,962
7993,37,075,8558,37075,565
48498,37,077,59031,37077,10533
18974,37,079,21168,37079,2194
421048,37,081,521330,37081,100282
57370,37,083,51766,37083,-5604
91025,37,085,130881,37085,39856
54033,37,087,60682,37087,6649
89173,37,089,114209,37089,25036
22601,37,091,24136,37091,1535
33646,37,093,53262,37093,19616
5826,37,095,5517,37095,-309
122660,37,097,172916,37097,50256
33121,37,099,42241,37099,9120
121965,37,101,191450,37101,69485
10381,37,103,9845,37103,-536
49040,37,105,59616,37105,10576
59648,37,107,57307,37107,-2341
63780,37,109,81168,37109,17388
42151,37,111,45075,37111,2924
29811,37,113,34376,37113,4565
19635,37,115,21340,37115,1705
25593,37,117,23172,37117,-2421
695454,37,119,1054835,37119,359381
15687,37,121,15126,37121,-561
26822,37,123,27418,37123,596
74769,37,125,95776,37125,21007
87420,37,127,94005,37127,6585
160307,37,129,223483,37129,63176
22086,37,131,20000,37131,-2086
150355,37,133,187136,37133,36781
118227,37,135,141796,37135,23569
12934,37,137,12821,37137,-113
34897,37,139,39864,37139,4967
41082,37,141,59090,37141,18008
11368,37,143,13335,37143,1967
35623,37,145,39284,37145,3661
133798,37,147,177220,37147,43422
18324,37,149,20334,37149,2010
130454,37,151,143416,37151,12962
46564,37,153,44939,37153,-1625
123339,37,155,133235,37155,9896
91928,37,157,91393,37157,-535
130340,37,159,139933,37159,9593
62899,37,161,66421,37161,3522
60161,37,163,63124,37163,2963
35998,37,165,35244,37165,-754
58100,37,167,60791,37167,2691
44711,37,169,46097,37169,1386
71219,37,171,72113,37171,894
12968,37,173,14346,37173,1378
29334,37,175,33482,37175,4148
4149,37,177,4141,37177,-8
123677,37,179,226606,37179,102929
42954,37,181,44244,37181,1290
627846,37,183,1046791,37183,418945
19972,37,185,19907,37185,-65
13723,37,187,12195,37187,-1528
42695,37,189,53922,37189,11227
113329,37,191,124150,37191,10821
65632,37,193,68740,37193,3108
73814,37,195,81661,37195,7847
36348,37,197,37532,37197,1184
17774,37,199,17678,37199,-96
2593,38,001,2305,38001,-288
11775,38,003,10926,38003,-849
6964,38,005,6739,38005,-225
888,38,007,934,38007,46
7149,38,009,6579,38009,-570
3242,38,011,3241,38011,-1
2242,38,013,2198,38013,-44
69416,38,015,94487,38015,25071
123138,38,017,175249,38017,52111
4831,38,019,3827,38019,-1004
5757,38,021,5064,38021,-693
2283,38,023,2413,38023,130
3600,38,025,4366,38025,766
2757,38,027,2358,38027,-399
4331,38,029,3346,38029,-985
3759,38,031,3303,38031,-456
1924,38,033,1817,38033,-107
66109,38,035,71083,38035,4974
2841,38,037,2377,38037,-464
2754,38,039,2277,38039,-477
2715,38,041,2629,38041,-86
2753,38,043,2414,38043,-339
4701,38,045,4111,38045,-590
2308,38,047,1941,38047,-367
5987,38,049,5963,38049,-24
3390,38,051,2656,38051,-734
5737,38,053,12621,38053,6884
9311,38,055,9729,38055,418
8644,38,057,8694,38057,50
25303,38,059,30809,38059,5506
6631,38,061,10242,38061,3611
3715,38,063,2960,38063,-755
2065,38,065,1870,38065,-195
8585,38,067,7069,38067,-1516
4675,38,069,4267,38069,-408
12066,38,071,11547,38071,-519
5890,38,073,5404,38073,-486
2610,38,075,2550,38075,-60
17998,38,077,16353,38077,-1645
13674,38,079,14659,38079,985
4366,38,081,3890,38081,-476
1710,38,083,1322,38083,-388
4044,38,085,4469,38085,425
767,38,087,763,38087,-4
22636,38,089,31199,38089,8563
2258,38,091,1962,38091,-296
21908,38,093,21128,38093,-780
2876,38,095,2263,38095,-613
8477,38,097,8030,38097,-447
12389,38,099,10904,38099,-1485
58795,38,101,70210,38101,11415
5102,38,103,4098,38103,-1004
19761,38,105,34337,38105,14576
27330,39,001,27907,39001,577
108473,39,003,103742,39003,-4731
52523,39,005,53652,39005,1129
102728,39,007,98231,39007,-4497
62223,39,009,66186,39009,3963
46611,39,011,45894,39011,-717
70226,39,013,68673,39013,-1553
42285,39,015,43759,39015,1474
332807,39,017,377537,39017,44730
28836,39,019,27669,39019,-1167
38890,39,021,38747,39021,-143
144742,39,023,134786,39023,-9956
177977,39,025,203022,39025,25045
40543,39,027,41902,39027,1359
112075,39,029,103685,39029,-8390
36655,39,031,36602,39031,-53
46966,39,033,42083,39033,-4883
1393978,39,035,1249352,39035,-144626
53309,39,037,51778,39037,-1531
39500,39,039,38158,39039,-1342
109989,39,041,196463,39041,86474
79551,39,043,75107,39043,-4444
122759,39,045,152597,39045,29838
28433,39,047,28676,39047,243
1068978,39,049,1264518,39049,195540
42084,39,051,42514,39051,430
31069,39,053,30015,39053,-1054
90895,39,055,94060,39055,3165
147886,39,057,164765,39057,16879
40792,39,059,39063,39059,-1729
845303,39,061,809099,39061,-36204
71295,39,063,75872,39063,4577
31945,39,065,31474,39065,-471
15856,39,067,15307,39067,-549
29210,39,069,27629,39069,-1581
40875,39,071,43029,39071,2154
28241,39,073,28340,39073,99
38943,39,075,43936,39075,4993
59487,39,077,58439,39077,-1048
32641,39,079,32505,39079,-136
73894,39,081,66704,39081,-7190
54500,39,083,60814,39083,6314
227511,39,085,228614,39085,1103
62319,39,087,60872,39087,-1447
145491,39,089,172198,39089,26707
46005,39,091,45165,39091,-840
284664,39,093,306365,39093,21701
455054,39,095,432488,39095,-22566
40213,39,097,43419,39097,3206
257555,39,099,230008,39099,-27547
66217,39,101,65096,39101,-1121
151095,39,103,177221,39103,26126
23072,39,105,23125,39105,53
40924,39,107,40909,39107,-15
98868,39,109,104679,39109,5811
15180,39,111,14210,39111,-970
559062,39,113,531239,39113,-27823
14897,39,115,14804,39115,-93
31628,39,117,35036,39117,3408
84585,39,119,86068,39119,1483
14058,39,121,14294,39121,236
40985,39,123,40636,39123,-349
20293,39,125,18865,39125,-1428
34078,39,127,35927,39127,1849
52727,39,129,57565,39129,4838
27695,39,131,28160,39131,465
152061,39,133,161921,39133,9860
42337,39,135,41247,39135,-1090
34726,39,137,34056,39137,-670
128852,39,139,121107,39139,-7745
73345,39,141,77000,39141,3655
61792,39,143,59330,39143,-2462
79195,39,145,76088,39145,-3107
58683,39,147,55353,39147,-3330
47910,39,149,48623,39149,713
378098,39,151,373612,39151,-4486
542899,39,153,540300,39153,-2599
225116,39,155,201825,39155,-23291
90914,39,157,92420,39157,1506
40909,39,159,55457,39159,14548
29659,39,161,28362,39161,-1297
12806,39,163,12921,39163,115
158383,39,165,227063,39165,68680
63251,39,167,60610,39167,-2641
111564,39,169,116470,39169,4906
39188,39,171,37017,39171,-2171
121065,39,173,130219,39173,9154
22908,39,175,22118,39175,-790
21038,40,001,22098,40001,1060
6105,40,003,5827,40003,-278
13879,40,005,13810,40005,-69
5857,40,007,5382,40007,-475
19799,40,009,22519,40009,2720
11976,40,011,9643,40011,-2333
36534,40,013,45573,40013,9039
30150,40,015,29557,40015,-593
87697,40,017,136532,40017,48835
45621,40,019,48556,40019,2935
42521,40,021,48700,40021,6179
15342,40,023,14885,40023,-457
3148,40,025,2162,40025,-986
208016,40,027,278655,40027,70639
6031,40,029,5651,40029,-380
114996,40,031,122136,40031,7140
6614,40,033,5941,40033,-673
14950,40,035,14625,40035,-325
67367,40,037,71312,40037,3945
26142,40,039,29293,40039,3151
37077,40,041,41598,40041,4521
4743,40,043,4819,40043,76
4075,40,045,4080,40045,5
57813,40,047,62603,40047,4790
27210,40,049,27838,40049,628
45516,40,051,54655,40051,9139
5144,40,053,4465,40053,-679
6061,40,055,5998,40055,-63
3283,40,057,2704,40057,-579
3562,40,059,3717,40059,155
11792,40,061,12747,40061,955
14154,40,063,13566,40063,-588
28439,40,065,25497,40065,-2942
6818,40,067,6230,40067,-588
10513,40,069,11087,40069,574
48080,40,071,44943,40071,-3137
13926,40,073,15638,40073,1712
10227,40,075,9077,40075,-1150
10692,40,077,10414,40077,-278
48109,40,079,49873,40079,1764
32080,40,081,35129,40081,3049
33924,40,083,46588,40083,12664
8831,40,085,9997,40085,1166
27740,40,087,38682,40087,10942
34402,40,089,32822,40089,-1580
19456,40,091,19815,40091,359
7545,40,093,7772,40093,227
13184,40,095,16191,40095,3007
38369,40,097,40920,40097,2551
12623,40,099,13918,40099,1295
69451,40,101,69477,40101,26
11411,40,103,11384,40103,-27
10569,40,105,10419,40105,-150
11814,40,107,12167,40107,353
660448,40,109,782970,40109,122522
39685,40,111,39213,40111,-472
44437,40,113,47806,40113,3369
33194,40,115,31691,40115,-1503
16612,40,117,16485,40117,-127
68190,40,119,81131,40119,12941
43953,40,121,44173,40121,220
35143,40,123,38330,40123,3187
65521,40,125,72290,40125,6769
11667,40,127,11057,40127,-610
3436,40,129,3640,40129,204
70641,40,131,91766,40131,21125
24894,40,133,25207,40133,313
38972,40,135,41294,40135,2322
43182,40,137,44090,40137,908
20107,40,139,21098,40139,991
9287,40,141,7465,40141,-1822
563299,40,143,642940,40143,79641
57491,40,145,77679,40145,20188
48996,40,147,52087,40147,3091
11508,40,149,11447,40149,-61
9089,40,151,9201,40151,112
18486,40,153,20814,40153,2328
16741,41,001,16059,41001,-682
78153,41,003,89385,41003,11232
338391,41,005,408062,41005,69671
35630,41,007,38632,41007,3002
43560,41,009,50785,41009,7225
62779,41,011,63761,41011,982
19182,41,013,22570,41013,3388
21137,41,015,22713,41015,1576
115367,41,017,181307,41017,65940
100399,41,019,108457,41019,8058
1915,41,021,1854,41021,-61
7935,41,023,7158,41023,-777
7609,41,025,7292,41025,-317
20411,41,027,23232,41027,2821
181269,41,029,216527,41029,35258
19009,41,031,23080,41031,4071
75726,41,033,85904,41033,10178
63775,41,035,66443,41035,2668
7422,41,037,7837,41037,415
322959,41,039,369519,41039,46560
44479,41,041,47806,41041,3327
103069,41,043,122849,41043,19780
31615,41,045,30439,41045,-1176
284834,41,047,336316,41047,51482
10995,41,049,11274,41049,279
660486,41,051,799766,41051,139280
62380,41,053,81823,41053,19443
1934,41,055,1710,41055,-224
24262,41,057,26143,41057,1881
70548,41,059,76456,41059,5908
24530,41,061,26087,41061,1557
7226,41,063,6946,41063,-280
23791,41,065,26115,41065,2324
445342,41,067,582779,41067,137437
1547,41,069,1344,41069,-203
84992,41,071,105035,41071,20043
91292,42,001,102180,42001,10888
1281666,42,003,1225365,42003,-56301
72392,42,005,66486,42005,-5906
181412,42,007,167429,42007,-13983
49984,42,009,48325,42009,-1659
373638,42,011,414812,42011,41174
129144,42,013,124650,42013,-4494
62761,42,015,60770,42015,-1991
597635,42,017,626399,42017,28764
174083,42,019,186847,42019,12764
152598,42,021,134732,42021,-17866
5974,42,023,4677,42023,-1297
58802,42,025,63594,42025,4792
135758,42,027,161464,42027,25706
433501,42,029,516312,42029,82811
41765,42,031,38513,42031,-3252
83382,42,033,80596,42033,-2786
37914,42,035,39233,42035,1319
64151,42,037,66420,42037,2269
90366,42,039,86257,42039,-4109
213674,42,041,248506,42041,34832
251798,42,043,273707,42043,21909
550864,42,045,563402,42045,12538
35112,42,047,30480,42047,-4632
280843,42,049,276207,42049,-4636
148644,42,051,132733,42051,-15911
4946,42,053,7321,42053,2375
129313,42,055,153851,42055,24538
14261,42,057,14640,42057,379
40672,42,059,37197,42059,-3475
45586,42,061,45634,42061,48
89605,42,063,86364,42063,-3241
45932,42,065,44073,42065,-1859
22821,42,067,24863,42067,2042
213295,42,069,211321,42069,-1974
470658,42,071,538500,42071,67842
94643,42,073,87294,42073,-7349
120327,42,075,138863,42075,18536
312090,42,077,363147,42077,51057
319250,42,079,316383,42079,-2867
120044,42,081,115248,42081,-4796
45936,42,083,41883,42083,-4053
120293,42,085,112913,42085,-7380
46486,42,087,46342,42087,-144
138687,42,089,166098,42089,27411
750097,42,091,821725,42091,71628
18236,42,093,18343,42093,107
267066,42,095,302294,42095,35228
94556,42,097,92541,42097,-2015
43602,42,099,45820,42099,2218
1517550,42,101,1567872,42101,50322
46302,42,103,55562,42103,9260
18080,42,105,16885,42105,-1195
150336,42,107,143573,42107,-6763
37546,42,109,40468,42109,2922
80023,42,111,75061,42111,-4962
6556,42,113,6137,42113,-419
42238,42,115,40862,42115,-1376
41373,42,117,41467,42117,94
41624,42,119,45565,42119,3941
57565,42,121,52582,42121,-4983
43863,42,123,40025,42123,-3838
202897,42,125,207981,42125,5084
47722,42,127,50710,42127,2988
369993,42,129,355458,42129,-14535
28080,42,131,27521,42131,-559
381751,42,133,443744,42133,61993
50648,44,001,49067,44001,-1581
167090,44,003,164614,44003,-2476
85433,44,005,82784,44005,-2649
621602,44,007,633673,44007,12071
123546,44,009,126288,44009,2742
26167,45,001,24872,45001,-1295
142552,45,003,167458,45003,24906
11211,45,005,9045,45005,-2166
165740,45,007,196569,45007,30829
16658,45,009,14434,45009,-2224
23478,45,011,21483,45011,-1995
120937,45,013,183149,45013,62212
142651,45,015,210898,45015,68247
15185,45,017,14796,45017,-389
309969,45,019,396484,45019,86515
52537,45,021,56646,45021,4109
34068,45,023,32181,45023,-1887
42768,45,025,46013,45025,3245
32502,45,027,33951,45027,1449
38264,45,029,37923,45029,-341
67394,45,031,67234,45031,-160
30722,45,033,30858,45033,136
96413,45,035,153773,45035,57360
24595,45,037,26358,45037,1763
23454,45,039,22653,45039,-801
125761,45,041,138742,45041,12981
55797,45,043,61399,45043,5602
379616,45,045,498766,45045,119150
66271,45,047,70133,45047,3862
21386,45,049,19922,45049,-1464
196629,45,051,322342,45051,125713
20678,45,053,28465,45053,7787
52647,45,055,64097,45055,11450
61351,45,057,89594,45057,28243
69567,45,059,66777,45059,-2790
20119,45,061,17635,45061,-2484
216014,45,063,286196,45063,70182
9958,45,065,9643,45065,-315
35466,45,067,31726,45067,-3740
28818,45,069,26945,45069,-1873
36108,45,071,38079,45071,1971
66215,45,073,76355,45073,10140
91582,45,075,87903,45075,-3679
110757,45,077,122863,45077,12106
320677,45,079,409549,45079,88872
19181,45,081,20197,45081,1016
253791,45,083,301463,45083,47672
104646,45,085,107396,45085,2750
29881,45,087,27673,45087,-2208
37217,45,089,31955,45089,-5262
164614,45,091,258526,45091,93912
3058,46,003,2736,46003,-322
17023,46,005,18101,46005,1078
3574,46,007,3460,46007,-114
7260,46,009,6984,46009,-276
28220,46,011,34135,46011,5915
35460,46,013,39128,46013,3668
5364,46,015,5238,46015,-126
2032,46,017,2043,46017,11
9094,46,019,10205,46019,1111
1782,46,021,1378,46021,-404
9350,46,023,9396,46023,46
4143,46,025,3656,46025,-487
13537,46,027,14086,46027,549
25897,46,029,28063,46029,2166
4181,46,031,4132,46031,-49
7275,46,033,8596,46033,1321
18741,46,035,19903,46035,1162
6267,46,037,5571,46037,-696
4498,46,039,4231,46039,-267
5972,46,041,5742,46041,-230
3458,46,043,2932,46043,-526
4367,46,045,3952,46045,-415
7453,46,047,6849,46047,-604
2640,46,049,2354,46049,-286
7847,46,051,7148,46051,-699
4792,46,053,4171,46053,-621
2196,46,055,1892,46055,-304
5540,46,057,6028,46057,488
3741,46,059,3319,46059,-422
3139,46,061,3374,46061,235
1353,46,063,1278,46063,-75
16481,46,065,17600,46065,1119
8075,46,067,7368,46067,-707
1671,46,069,1352,46069,-319
2930,46,071,3326,46071,396
2295,46,073,2004,46073,-291
1193,46,075,927,46075,-266
5815,46,077,5001,46077,-814
11276,46,079,12909,46079,1633
21802,46,081,25281,46081,3479
24131,46,083,54469,46083,30338
3895,46,085,3894,46085,-1
5832,46,087,5625,46087,-207
2904,46,089,2438,46089,-466
4576,46,091,4801,46091,225
24253,46,093,27693,46093,3440
2083,46,095,2102,46095,19
2884,46,097,2281,46097,-603
148281,46,099,187318,46099,39037
6595,46,101,6505,46101,-90
88565,46,103,109372,46103,20807
3363,46,105,2983,46105,-380
2693,46,107,2299,46107,-394
10016,46,109,10255,46109,239
2675,46,111,2396,46111,-279
12466,46,113,,46113,
7454,46,115,6420,46115,-1034
2772,46,117,2993,46117,221
1556,46,119,1421,46119,-135
9050,46,121,10155,46121,1105
6430,46,123,5492,46123,-938
8849,46,125,8317,46125,-532
12584,46,127,14934,46127,2350
5974,46,129,5610,46129,-364
21652,46,135,22616,46135,964
2519,46,137,2801,46137,282
71330,47,001,75936,47001,4606
37586,47,003,47484,47003,9898
16537,47,005,16014,47005,-523
12367,47,007,14675,47007,2308
105823,47,009,128670,47009,22847
87965,47,011,104490,47011,16525
39854,47,013,39714,47013,-140
12826,47,015,14027,47015,1201
29475,47,017,28092,47017,-1383
56742,47,019,56502,47019,-240
35912,47,021,39880,47021,3968
15540,47,023,17453,47023,1913
29862,47,025,31757,47025,1895
7976,47,027,7752,47027,-224
33565,47,029,35219,47029,1654
48014,47,031,54682,47031,6668
14532,47,033,14411,47033,-121
46802,47,035,58655,47035,11853
569891,47,037,684410,47037,114519
11731,47,039,11769,47039,38
17423,47,041,19361,47041,1938
43156,47,043,52170,47043,9014
37279,47,045,37708,47045,429
28806,47,047,39590,47047,10784
16625,47,049,18033,47049,1408
39270,47,051,41700,47051,2430
48152,47,053,49401,47053,1249
29447,47,055,29307,47055,-140
20659,47,057,23072,47057,2413
62909,47,059,68615,47059,5706
14332,47,061,13389,47061,-943
58128,47,063,63785,47063,5657
307896,47,065,357738,47065,49842
6786,47,067,6577,47067,-209
28105,47,069,25435,47069,-2670
25578,47,071,25679,47071,101
53563,47,073,56563,47073,3000
19797,47,075,17853,47075,-1944
25522,47,077,27822,47077,2300
31115,47,079,32310,47079,1195
22295,47,081,24295,47081,2000
8088,47,083,8134,47083,46
17929,47,085,18347,47085,418
10984,47,087,11566,47087,582
44294,47,089,53535,47089,9241
17499,47,091,17754,47091,255
382032,47,093,456132,47093,74100
7954,47,095,7560,47095,-394
27101,47,097,26773,47097,-328
39926,47,099,43081,47099,3155
11367,47,101,11904,47101,537
31340,47,103,33645,47103,2305
39086,47,105,51454,47105,12368
49015,47,107,52850,47107,3835
24653,47,109,25935,47109,1282
20386,47,111,23450,47111,3064
91837,47,113,97663,47113,5826
27776,47,115,28446,47115,670
26767,47,117,31915,47117,5148
69498,47,119,89981,47119,20483
11086,47,121,12005,47121,919
38961,47,123,45970,47123,7009
134768,47,125,195734,47125,60966
5740,47,127,6323,47127,583
19757,47,129,21554,47129,1797
32450,47,131,30578,47131,-1872
20118,47,133,22051,47133,1933
7631,47,135,7964,47135,333
4945,47,137,5142,47137,197
16050,47,139,16772,47139,722
62315,47,141,75931,47141,13616
28400,47,143,32442,47143,4042
51910,47,145,52874,47145,964
54433,47,147,69165,47147,14732
182023,47,149,308251,47149,126228
21127,47,151,21947,47151,820
11370,47,153,14897,47153,3527
71170,47,155,96673,47155,25503
897472,47,157,934603,47157,37131
17712,47,159,19447,47159,1735
12370,47,161,13182,47161,812
153048,47,163,156667,47163,3619
130449,47,165,180063,47165,49614
51271,47,167,61303,47167,10032
7259,47,169,8271,47169,1012
17667,47,171,17719,47171,52
17808,47,173,19140,47173,1332
5508,47,175,5689,47175,181
38276,47,177,40516,47177,2240
107198,47,179,127440,47179,20242
16842,47,181,16713,47181,-129
34895,47,183,33507,47183,-1388
23102,47,185,26653,47185,3551
126638,47,187,219107,47187,92469
88809,47,189,132781,47189,43972
55109,48,001,57734,48001,2625
13004,48,003,17760,48003,4756
80130,48,005,87791,48005,7661
22497,48,007,25721,48007,3224
8854,48,009,8703,48009,-151
2148,48,011,1876,48011,-272
38628,48,013,48797,48013,10169
23590,48,015,29758,48015,6168
6594,48,017,7181,48017,587
17645,48,019,21776,48019,4131
57733,48,021,82733,48021,25000
4093,48,023,3697,48023,-396
32359,48,025,32750,48025,391
237974,48,027,340411,48027,102437
1392931,48,029,1928680,48029,535749
8418,48,031,11392,48031,2974
729,48,033,633,48033,-96
17204,48,035,18097,48035,893
89306,48,037,93860,48037,4554
241767,48,039,354195,48039,112428
152415,48,041,220417,48041,68002
8866,48,043,9200,48043,334
1790,48,045,1474,48045,-316
7976,48,047,7214,48047,-762
37674,48,049,38271,48049,597
16470,48,051,17760,48051,1290
34147,48,053,46243,48053,12096
32194,48,055,41161,48055,8967
20647,48,057,21965,48057,1318
12905,48,059,13820,48059,915
335227,48,061,422135,48061,86908
11549,48,063,12867,48063,1318
6516,48,065,6057,48065,-459
30438,48,067,30375,48067,-63
8285,48,069,7669,48069,-616
26031,48,071,39899,48071,13868
46659,48,073,51668,48073,5009
7688,48,075,7052,48075,-636
11006,48,077,10193,48077,-813
3730,48,079,2882,48079,-848
3864,48,081,3264,48081,-600
9235,48,083,8420,48083,-815
491675,48,085,939585,48085,447910
3206,48,087,3016,48087,-190
20390,48,089,21019,48089,629
78021,48,091,134788,48091,56767
14026,48,093,13484,48093,-542
3966,48,095,4279,48095,313
36363,48,097,39266,48097,2903
74978,48,099,74686,48099,-292
1904,48,101,1402,48101,-502
3996,48,103,4830,48103,834
4099,48,105,3675,48105,-424
7072,48,107,5992,48107,-1080
2975,48,109,2198,48109,-777
6222,48,111,7056,48111,834
2218899,48,113,2574984,48113,356085
14985,48,115,13111,48115,-1874
18561,48,117,18830,48117,269
5327,48,119,5215,48119,-112
432976,48,121,806180,48121,373204
20013,48,123,20865,48123,852
2762,48,125,2184,48125,-578
10248,48,127,10794,48127,546
3828,48,129,3405,48129,-423
13120,48,131,11428,48131,-1692
18297,48,133,18274,48133,-23
121123,48,135,157462,48135,36339
2162,48,137,1911,48137,-251
111360,48,139,168499,48139,57139
679622,48,141,837918,48141,158296
33001,48,143,41659,48143,8658
18576,48,145,17273,48145,-1303
31242,48,147,34031,48147,2789
21804,48,149,25149,48149,3345
4344,48,151,3854,48151,-490
7771,48,153,5917,48153,-1854
1622,48,155,1183,48155,-439
354452,48,157,741237,48157,386785
9458,48,159,10607,48159,1149
17867,48,161,19624,48161,1757
16252,48,163,18956,48163,2704
14467,48,165,20478,48165,6011
250158,48,167,329431,48167,79273
4872,48,169,6442,48169,1570
20814,48,171,26521,48171,5707
1406,48,173,1314,48173,-92
6928,48,175,7517,48175,589
18628,48,177,20876,48177,2248
22744,48,179,22725,48179,-19
110595,48,181,128235,48181,17640
111379,48,183,123745,48183,12366
23552,48,185,27671,48185,4119
89023,48,187,155265,48187,66242
36602,48,189,34263,48189,-2339
3782,48,191,3138,48191,-644
8229,48,193,8304,48193,75
5369,48,195,5538,48195,169
4724,48,197,3906,48197,-818
48073,48,199,56322,48199,8249
3400578,48,201,4589928,48201,1189350
62110,48,203,66534,48203,4424
5537,48,205,5747,48205,210
6093,48,207,5681,48207,-412
97589,48,209,204470,48209,106881
3351,48,211,4129,48211,778
73277,48,213,79901,48213,6624
569463,48,215,849843,48215,280380
32321,48,217,35077,48217,2756
22716,48,219,23275,48219,559
41100,48,221,56857,48221,15757
31960,48,223,36400,48223,4440
23185,48,225,22754,48225,-431
33627,48,227,36708,48227,3081
3344,48,229,4053,48229,709
76596,48,231,92073,48231,15477
23857,48,233,21511,48233,-2346
1771,48,235,1557,48235,-214
8763,48,237,8744,48237,-19
14391,48,239,14869,48239,478
35604,48,241,35648,48241,44
2207,48,243,2200,48243,-7
252051,48,245,254679,48245,2628
5281,48,247,5146,48247,-135
39326,48,249,41149,48249,1823
126811,48,251,163274,48251,36463
20785,48,253,20009,48253,-776
15446,48,255,15254,48255,-192
71313,48,257,118350,48257,47037
23743,48,259,42540,48259,18797
414,48,261,404,48261,-10
859,48,263,769,48263,-90
43653,48,265,51504,48265,7851
4468,48,267,4423,48267,-45
356,48,269,289,48269,-67
3379,48,271,3590,48271,211
31549,48,273,31690,48273,141
4253,48,275,3806,48275,-447
48499,48,277,49791,48277,1292
14709,48,279,13275,48279,-1434
17762,48,281,20760,48281,2998
5866,48,283,7613,48283,1747
19210,48,285,19809,48285,599
15657,48,287,17055,48287,1398
15335,48,289,17299,48289,1964
70154,48,291,81704,48291,11550
22051,48,293,23468,48293,1417
3057,48,295,3487,48295,430
12309,48,297,12056,48297,-253
17044,48,299,20362,48299,3318
67,48,301,113,48301,46
242628,48,303,303137,48303,60509
6550,48,305,5711,48305,-839
8205,48,307,8172,48307,-33
213517,48,309,247934,48309,34417
851,48,311,804,48311,-47
12940,48,313,13987,48313,1047
10941,48,315,10147,48315,-794
4746,48,317,5723,48317,977
3738,48,319,4111,48319,373
37957,48,321,37187,48321,-770
47297,48,323,57685,48323,10388
39304,48,325,49283,48325,9979
2360,48,327,2123,48327,-237
116009,48,329,162565,48329,46556
24238,48,331,24871,48331,633
5151,48,333,4907,48333,-244
9698,48,335,8720,48335,-978
19117,48,337,19414,48337,297
293768,48,339,556203,48339,262435
20121,48,341,22120,48341,1999
13048,48,343,12593,48343,-455
1426,48,345,1160,48345,-266
59203,48,347,65806,48347,6603
45124,48,349,48523,48349,3399
15072,48,351,14003,48351,-1069
15802,48,353,14993,48353,-809
313645,48,355,361350,48355,47705
9006,48,357,10306,48357,1300
2185,48,359,2076,48359,-109
84966,48,361,84964,48361,-2
27026,48,363,28053,48363,1027
22756,48,365,23492,48365,736
88495,48,367,129441,48367,40946
10016,48,369,9776,48369,-240
16809,48,371,15970,48371,-839
41133,48,373,47916,48373,6783
113546,48,375,120832,48375,7286
7304,48,377,6958,48377,-346
9139,48,379,11314,48379,2175
104312,48,381,132501,48381,28189
3326,48,383,3608,48383,282
3047,48,385,3389,48385,342
14314,48,387,12207,48387,-2107
13137,48,389,14921,48389,1784
7828,48,391,7321,48391,-507
887,48,393,916,48393,29
16000,48,395,16751,48395,751
43080,48,397,93978,48397,50898
11495,48,399,10448,48399,-1047
47372,48,401,52732,48401,5360
10469,48,403,10303,48403,-166
8946,48,405,8320,48405,-626
22246,48,407,27707,48407,5461
67138,48,409,67655,48409,517
6186,48,411,5944,48411,-242
2935,48,413,3056,48413,121
16361,48,415,17333,48415,972
3302,48,417,3315,48417,13
25224,48,419,25579,48419,355
3186,48,421,3068,48421,-118
174706,48,423,225290,48423,50584
6809,48,425,8775,48425,1966
53597,48,427,64122,48427,10525
9674,48,429,9906,48429,232
1393,48,431,1367,48431,-26
1693,48,433,1426,48433,-267
4077,48,435,3869,48435,-208
8378,48,437,7466,48437,-912
1446219,48,439,2016872,48439,570653
126555,48,441,136535,48441,9980
1081,48,443,812,48443,-269
12761,48,445,12799,48445,38
1850,48,447,1533,48447,-317
28118,48,449,32592,48449,4474
104010,48,451,118386,48451,14376
812280,48,453,1199323,48453,387043
13779,48,455,14442,48455,663
20871,48,457,21320,48457,449
35291,48,459,40969,48459,5678
3404,48,461,3673,48461,269
25926,48,463,27285,48463,1359
44856,48,465,48881,48465,4025
48140,48,467,54355,48467,6215
84088,48,469,92467,48469,8379
61758,48,471,71484,48471,9726
32663,48,473,50115,48473,17452
10909,48,475,11600,48475,691
30373,48,477,35056,48477,4683
193117,48,479,271193,48479,78076
41188,48,481,41735,48481,547
5284,48,483,5546,48483,262
131664,48,485,131838,48485,174
14676,48,487,12892,48487,-1784
20082,48,489,21810,48489,1728
249967,48,491,528718,48491,278751
32408,48,493,48480,48493,16072
7173,48,495,7893,48495,720
48793,48,497,64455,48497,15662
36752,48,499,44227,48499,7475
7322,48,501,8488,48501,1166
17943,48,503,18152,48503,209
12182,48,505,14349,48505,2167
11600,48,507,12023,48507,423
6005,49,001,6463,49001,458
42745,49,003,53139,49003,10394
91391,49,005,122753,49005,31362
20422,49,007,20399,49007,-23
921,49,009,1095,49009,174
238994,49,011,342281,49011,103287
14371,49,013,20337,49013,5966
10860,49,015,10216,49015,-644
4735,49,017,4986,49017,251
8485,49,019,9579,49019,1094
33779,49,021,49937,49021,16158
8238,49,023,11010,49023,2772
6046,49,025,7334,49025,1288
12405,49,027,12694,49027,289
7129,49,029,11437,49029,4308
1435,49,031,1466,49031,31
1961,49,033,2319,49033,358
898387,49,035,1121354,49035,222967
14413,49,037,16895,49037,2482
22763,49,039,29409,49039,6646
18842,49,041,21267,49041,2425
29736,49,043,40307,49043,10571
40735,49,045,64833,49045,24098
25224,49,047,36373,49047,11149
368536,49,049,592299,49049,223763
15215,49,051,30528,49051,15313
90354,49,053,160245,49053,69891
2509,49,055,2702,49055,193
196533,49,057,247560,49057,51027
35974,50,001,36959,50001,985
36994,50,003,36191,50003,-803
29702,50,005,30333,50005,631
146571,50,007,161531,50007,14960
6459,50,009,6176,50009,-283
45417,50,011,48915,50011,3498
6901,50,013,6919,50013,18
23233,50,015,25333,50015,2100
28226,50,017,28919,50017,693
26277,50,019,26863,50019,586
63400,50,021,59310,50021,-4090
58039,50,023,58504,50023,465
44216,50,025,43145,50025,-1071
57418,50,027,55496,50027,-1922
38305,51,001,32947,51001,-5358
79236,51,003,106878,51003,27642
12926,51,005,15595,51005,2669
11400,51,007,12913,51007,1513
31894,51,009,31633,51009,-261
13705,51,011,15475,51011,1770
189453,51,013,230050,51013,40597
65615,51,015,74997,51015,9382
5048,51,017,4476,51017,-572
60371,51,019,77960,51019,17589
6871,51,021,6513,51021,-358
30496,51,023,33231,51023,2735
18419,51,025,16243,51025,-2176
26978,51,027,22178,51027,-4800
15623,51,029,17048,51029,1425
51078,51,031,54952,51031,3874
22121,51,033,30178,51033,8057
29245,51,035,29531,51035,286
6926,51,036,7071,51036,145
12472,51,037,12129,51037,-343
259903,51,041,339009,51041,79106
12652,51,043,14374,51043,1722
5091,51,045,5158,51045,67
34262,51,047,50083,51047,15821
9017,51,049,9652,51049,635
16395,51,051,14968,51051,-1427
24533,51,053,28144,51053,3611
9989,51,057,11123,51057,1134
969749,51,059,1138652,51059,168903
55139,51,061,69069,51061,13930
13874,51,063,15731,51063,1857
20047,51,065,26271,51065,6224
47286,51,067,56069,51067,8783
59209,51,069,84421,51069,25212
16657,51,071,16857,51071,200
34780,51,073,37214,51073,2434
16863,51,075,22668,51075,5805
17917,51,077,15107,51077,-2810
15244,51,079,19371,51079,4127
11560,51,081,11706,51081,146
37355,51,083,34992,51083,-2363
86320,51,085,104392,51085,18072
262300,51,087,326501,51087,64201
57930,51,089,51445,51089,-6485
2536,51,091,2216,51091,-320
29728,51,093,36596,51093,6868
48102,51,095,74404,51095,26302
6630,51,097,7159,51097,529
16803,51,099,25984,51099,9181
13146,51,101,16334,51101,3188
11567,51,103,10972,51103,-595
23589,51,105,24179,51105,590
169599,51,107,385945,51107,216346
25627,51,109,35236,51109,9609
13146,51,111,12273,51111,-873
12520,51,113,13078,51113,558
9207,51,115,8782,51115,-425
32380,51,117,30892,51117,-1488
9932,51,119,10778,51119,846
83629,51,121,98602,51121,14973
14445,51,125,14869,51125,424
13462,51,127,21147,51127,7685
13093,51,131,12139,51131,-954
12259,51,133,12222,51133,-37
15725,51,135,15595,51135,-130
25881,51,137,35533,51137,9652
23177,51,139,23654,51139,477
19407,51,141,17923,51141,-1484
61745,51,143,61687,51143,-58
22377,51,145,28443,51145,6066
19720,51,147,23142,51147,3422
33047,51,149,37845,51149,4798
280813,51,153,455210,51153,174397
35127,51,155,34203,51155,-924
6983,51,157,7388,51157,405
8809,51,159,8774,51159,-35
85778,51,161,94031,51161,8253
20808,51,163,22392,51163,1584
67725,51,165,79744,51165,12019
30308,51,167,27370,51167,-2938
23403,51,169,21930,51169,-1473
35075,51,171,43175,51171,8100
33081,51,173,31062,51173,-2019
17482,51,175,18057,51175,575
90395,51,177,132010,51177,41615
92446,51,179,144361,51179,51915
6829,51,181,6544,51181,-285
12504,51,183,11504,51183,-1000
44598,51,185,42150,51185,-2448
31584,51,187,39155,51187,7571
51103,51,191,54214,51191,3111
16718,51,193,17592,51193,874
40123,51,195,39228,51195,-895
27599,51,197,29016,51197,1417
56297,51,199,67976,51199,11679
128283,51,510,155810,51510,27527
6299,51,515,,51515,
17367,51,520,16960,51520,-407
6349,51,530,6452,51530,103
45049,51,540,46912,51540,1863
199184,51,550,237940,51550,38756
4289,51,560,,51560,
16897,51,570,17772,51570,875
6303,51,580,5518,51580,-785
48411,51,590,41898,51590,-6513
5665,51,595,5305,51595,-360
21498,51,600,24164,51600,2666
10377,51,610,14014,51610,3637
8346,51,620,8306,51620,-40
19279,51,630,28297,51630,9018
6837,51,640,6775,51640,-62
146437,51,650,135410,51650,-11027
40468,51,660,53078,51660,12610
22354,51,670,22735,51670,381
6867,51,678,7045,51678,178
65269,51,680,80212,51680,14943
35135,51,683,41483,51683,6348
10290,51,685,15915,51685,5625
15416,51,690,13445,51690,-1971
180150,51,700,181825,51700,1675
234403,51,710,245115,51710,10712
3904,51,720,3864,51720,-40
33740,51,730,31882,51730,-1858
11566,51,735,12017,51735,451
100565,51,740,95252,51740,-5313
15859,51,750,17483,51750,1624
197790,51,760,223170,51760,25380
94911,51,770,99660,51770,4749
24747,51,775,25549,51775,802
23853,51,790,24363,51790,510
63677,51,800,89273,51800,25596
425257,51,810,452602,51810,27345
19520,51,820,21887,51820,2367
11998,51,830,15214,51830,3216
23585,51,840,27516,51840,3931
16428,53,001,19238,53001,2810
20551,53,003,22306,53003,1755
142475,53,005,193686,53005,51211
66616,53,007,76338,53007,9722
64525,53,009,74570,53009,10045
345238,53,011,467018,53011,121780
4064,53,013,3938,53013,-126
92948,53,015,105160,53015,12212
32603,53,017,41327,53017,8724
7260,53,019,7614,53019,354
49347,53,021,90160,53021,40813
2397,53,023,2247,53023,-150
74698,53,025,93546,53025,18848
67194,53,027,71628,53027,4434
71558,53,029,82636,53029,11078
25953,53,031,31139,53031,5186
1737034,53,033,2149970,53033,412936
231969,53,035,264811,53035,32842
33362,53,037,44866,53037,11504
19161,53,039,21301,53039,2140
68600,53,041,77066,53041,8466
10184,53,043,10350,53043,166
49405,53,045,62198,53045,12793
39564,53,047,41554,53047,1990
20984,53,049,21249,53049,265
11732,53,051,13123,53051,1391
700820,53,053,861312,53053,160492
14077,53,055,16339,53055,2262
102979,53,057,123681,53057,20702
9872,53,059,11510,53059,1638
606024,53,061,787620,53061,181596
417939,53,063,499072,53063,81133
40066,53,065,44439,53065,4373
207355,53,067,275222,53067,67867
3824,53,069,4139,53069,315
55180,53,071,60340,53071,5160
166814,53,073,216800,53073,49986
40740,53,075,48851,53075,8111
222581,53,077,249636,53077,27055
15557,54,001,16831,54001,1274
75905,54,003,113525,54003,37620
25535,54,005,22816,54005,-2719
14702,54,007,14471,54007,-231
25447,54,009,22977,54009,-2470
96784,54,011,95987,54011,-797
7582,54,013,7336,54013,-246
10330,54,015,8859,54015,-1471
7403,54,017,8413,54017,1010
47579,54,019,44323,54019,-3256
7160,54,021,8249,54021,1089
11299,54,023,11732,54023,433
34453,54,025,35279,54025,826
20203,54,027,23301,54027,3098
32667,54,029,29590,54029,-3077
12669,54,031,13889,54031,1220
68652,54,033,68400,54033,-252
28000,54,035,29152,54035,1152
42190,54,037,56368,54037,14178
200073,54,039,186241,54039,-13832
16919,54,041,16309,54041,-610
22108,54,043,21232,54043,-876
37710,54,045,33700,54045,-4010
27329,54,047,19141,54047,-8188
56598,54,049,56538,54049,-60
35519,54,051,31793,54051,-3726
25957,54,053,26825,54053,868
62980,54,055,60468,54055,-2512
27078,54,057,27411,54057,333
28253,54,059,24647,54059,-3606
81866,54,061,104622,54061,22756
14583,54,063,13370,54063,-1213
14943,54,065,17632,54065,2689
26562,54,067,25311,54067,-1251
47427,54,069,42516,54069,-4911
8196,54,071,7051,54071,-1145
7514,54,073,7591,54073,77
9131,54,075,8501,54075,-630
29334,54,077,33758,54077,4424
51589,54,079,56941,54079,5352
79220,54,081,76601,54081,-2619
28262,54,083,29006,54083,744
10343,54,085,9875,54085,-468
15446,54,087,14208,54087,-1238
12999,54,089,12872,54089,-127
16089,54,091,16859,54091,770
7321,54,093,6926,54093,-395
9592,54,095,8972,54095,-620
23404,54,097,24658,54097,1254
42903,54,099,40531,54099,-2372
9719,54,101,8646,54101,-1073
17693,54,103,15640,54103,-2053
5873,54,105,5806,54105,-67
87986,54,107,85643,54107,-2343
25708,54,109,21763,54109,-3945
18643,55,001,20069,55001,1426
16866,55,003,15714,55003,-1152
44963,55,005,45412,55005,449
15013,55,007,14891,55007,-122
226778,55,009,260401,55009,33623
13804,55,011,13099,55011,-705
15674,55,013,15213,55013,-461
40631,55,015,49553,55015,8922
55195,55,017,63649,55017,8454
33557,55,019,34557,55019,1000
52468,55,021,56927,55021,4459
17243,55,023,16321,55023,-922
426526,55,025,531273,55025,104747
85897,55,027,88068,55027,2171
27961,55,029,27587,55029,-374
43287,55,031,43509,55031,222
39858,55,033,44704,55033,4846
93142,55,035,102965,55035,9823
5088,55,037,4456,55037,-632
97296,55,039,102144,55039,4848
10024,55,041,9064,55041,-960
49597,55,043,52214,55043,2617
33647,55,045,37075,55045,3428
19105,55,047,18719,55047,-386
22780,55,049,23654,55049,874
6861,55,051,5726,55051,-1135
19100,55,053,20562,55053,1462
74021,55,055,84625,55055,10604
24316,55,057,26274,55057,1958
149577,55,059,168183,55059,18606
20187,55,061,20405,55061,218
107120,55,063,118122,55063,11002
16137,55,065,16753,55065,616
20740,55,067,19221,55067,-1519
29641,55,069,27902,55069,-1739
82887,55,071,79536,55071,-3351
125834,55,073,135603,55073,9769
43384,55,075,40491,55075,-2893
15832,55,077,15067,55077,-765
4562,55,078,4533,55078,-29
940164,55,079,951448,55079,11284
40899,55,081,45623,55081,4724
35634,55,083,37430,55083,1796
36776,55,085,35601,55085,-1175
160971,55,087,184526,55087,23555
82317,55,089,88314,55089,5997
7213,55,091,7307,55091,94
36804,55,093,41238,55093,4434
41319,55,095,43481,55095,2162
67182,55,097,70447,55097,3265
15822,55,099,13517,55099,-2305
188831,55,101,195140,55101,6309
17924,55,103,17476,55103,-448
152307,55,105,161620,55105,9313
15347,55,107,14127,55107,-1220
63155,55,109,88029,55109,24874
55225,55,111,63949,55111,8724
16196,55,113,16369,55113,173
40664,55,115,41062,55115,398
112646,55,117,115427,55117,2781
19680,55,119,20439,55119,759
27010,55,121,29633,55121,2623
28056,55,123,30814,55123,2758
21033,55,125,21435,55125,402
93759,55,127,102959,55127,9200
16036,55,129,15648,55129,-388
117493,55,131,134296,55131,16803
360767,55,133,398424,55133,37657
51731,55,135,51533,55135,-198
23154,55,137,24162,55137,1008
156763,55,139,169886,55139,13123
75555,55,141,73107,55141,-2448
32014,56,001,38256,56001,6242
11461,56,003,12005,56003,544
33698,56,005,48803,56005,15105
15639,56,007,15618,56007,-21
12052,56,009,14191,56009,2139
5887,56,011,7464,56011,1577
35804,56,013,40242,56013,4438
12538,56,015,13390,56015,852
4882,56,017,4679,56017,-203
7075,56,019,8486,56019,1411
81607,56,021,98136,56021,16529
14573,56,023,19110,56023,4537
66533,56,025,81039,56025,14506
2407,56,027,2480,56027,73
25786,56,029,29353,56029,3567
8807,56,031,8680,56031,-127
26560,56,033,30200,56033,3640
5920,56,035,9769,56035,3849
37613,56,037,44165,56037,6552
18251,56,039,23191,56039,4940
19742,56,041,20773,56041,1031
8289,56,043,8235,56043,-54