TRACT_CODE,TENURE_RENT,TENURE_TOT,TENURE_OWN,B25064_001E_2011,B25064_001E_2016,Rent_Percent_Change
84006001400100,128,1292,1164,2001,3202,0.6001999
84006001400200,282,813,531,1497,1770,0.182364729
84006001400300,1303,2439,1136,1058,1208,0.141776938
84006001400400,1090,1798,708,1423,1584,0.113141251
84006001400500,1034,1643,609,1024,1438,0.404296875
84006001400600,394,713,319,1025,1221,0.191219512
84006001400700,1143,1787,644,1247,1197,-0.040096231
84006001400800,1008,1580,572,1122,1329,0.184491979
84006001400900,720,1025,305,1159,1457,0.257118205
84006001401000,1826,2619,793,1137,1191,0.047493404
84006001401100,1500,2032,532,1036,1324,0.277992278
84006001401200,794,1231,437,1291,1371,0.061967467
84006001401300,1476,1705,229,928,972,0.047413793
84006001401400,1317,1544,227,888,982,0.105855856
84006001401500,655,1023,368,754,1029,0.364721485
84006001401600,611,781,170,1050,1183,0.126666667
84006001401700,626,1231,605,1343,1229,-0.084884587
84006001401800,563,731,168,815,944,0.158282209
84006001402200,539,838,299,931,956,0.026852846
84006001402400,958,1151,193,920,840,-0.086956522
84006001402500,602,704,102,414,746,0.801932367
84006001402600,553,654,101,744,801,0.076612903
84006001402700,599,680,81,959,1072,0.117831074
84006001402800,2165,2295,130,503,771,0.532803181
84006001402900,848,853,5,663,886,0.336349925
84006001403000,1261,1611,350,473,631,0.334038055
84006001403100,516,712,196,590,909,0.540677966
84006001403300,1672,2158,486,1424,1414,-0.007022472
84006001403400,2470,2746,276,982,1135,0.155804481
84006001403501,2255,2583,328,888,1010,0.137387387
84006001403502,903,1170,267,1114,1426,0.280071813
84006001403600,2140,2530,390,1176,1317,0.119897959
84006001403701,1472,1683,211,1092,1306,0.195970696
84006001403702,847,1123,276,1295,1621,0.251737452
84006001403800,1221,1808,587,1290,1477,0.14496124
84006001403900,1472,2244,772,1212,1379,0.137788779
84006001404000,1161,1650,489,1156,1323,0.144463668
84006001404101,1018,1679,661,1234,1523,0.234197731
84006001404102,1261,1515,254,1008,1279,0.268849206
84006001404200,283,1285,1002,1904,2263,0.18855042
84006001404300,228,1252,1024,2001,1773,-0.113943028
84006001404400,338,2317,1979,2001,2280,0.139430285
84006001404501,94,679,585,2001,1804,-0.098450775
84006001404502,282,2339,2057,2001,2262,0.130434783
84006001404600,140,1761,1621,1658,2750,0.658624849
84006001404700,74,795,721,1838,2409,0.310663765
84006001404800,643,1243,600,954,1105,0.158280922
84006001404900,749,1945,1196,1147,1112,-0.030514385
84006001405000,553,1476,923,1579,1522,-0.036098797
84006001405100,150,1565,1415,1493,1428,-0.043536504
84006001405200,1767,2391,624,1168,1368,0.171232877
84006001405301,1349,1517,168,1131,1278,0.129973475
84006001405302,1426,1488,62,807,950,0.177199504
84006001405401,1448,1655,207,943,993,0.053022269
84006001405402,1024,1155,131,919,1138,0.238302503
84006001405500,1311,1615,304,1094,1128,0.031078611
84006001405600,948,1411,463,998,1185,0.187374749
84006001405700,1042,1372,330,944,1044,0.105932203
84006001405800,843,1320,477,971,1179,0.214212152
84006001405901,715,1057,342,963,928,-0.036344756
84006001405902,678,916,238,1021,968,-0.051909892
84006001406000,1289,1448,159,943,745,-0.209968187
84006001406100,1033,1496,463,957,1343,0.403343783
84006001406201,1091,1352,261,928,997,0.074353448
84006001406202,1163,1305,142,936,987,0.054487179
84006001406300,774,1203,429,887,1062,0.19729425
84006001406400,436,716,280,883,1370,0.551528879
84006001406500,1430,2018,588,975,1152,0.181538462
84006001406601,885,1679,794,1070,1361,0.271962617
84006001406602,662,959,297,939,1085,0.155484558
84006001406700,829,2130,1301,1053,1334,0.2668566
84006001406800,449,1368,919,1175,1386,0.179574468
84006001406900,757,1528,771,1134,1410,0.243386243
84006001407000,1084,1953,869,1037,1259,0.214079074
84006001407101,661,1020,359,918,1024,0.11546841
84006001407102,677,1288,611,918,1130,0.230936819
84006001407200,1426,1801,375,913,1013,0.109529025
84006001407300,530,744,214,1329,1503,0.130925508
84006001407400,826,1147,321,919,1064,0.157780196
84006001407500,924,1279,355,889,949,0.067491564
84006001407600,996,2186,1190,949,952,0.003161222
84006001407700,505,1646,1141,1304,2016,0.54601227
84006001407800,253,759,506,1742,1048,-0.398392652
84006001407900,268,1113,845,1597,1632,0.021916093
84006001408000,137,970,833,2001,3159,0.578710645
84006001408100,490,2662,2172,1519,1806,0.188940092
84006001408200,1005,1703,698,993,1199,0.207452165
84006001408300,660,1762,1102,1275,1079,-0.15372549
84006001408400,666,1086,420,1239,1222,-0.013720743
84006001408500,1098,1617,519,1083,1291,0.192059095
84006001408600,1120,1811,691,941,1142,0.21360255
84006001408700,1543,2325,782,1099,1272,0.157415833
84006001408800,1607,1950,343,866,769,-0.112009238
84006001408900,664,944,280,1032,1095,0.061046512
84006001409000,533,1038,505,1269,1442,0.136327817
84006001409100,240,634,394,1117,1550,0.387645479
84006001409200,463,923,460,1178,1301,0.104414261
84006001409300,876,1553,677,1039,1201,0.155919153
84006001409400,772,1230,458,1024,1301,0.270507813
84006001409500,808,1117,309,1035,1134,0.095652174
84006001409600,891,1382,491,1316,1138,-0.135258359
84006001409700,972,1524,552,1042,1290,0.238003839
84006001409800,604,1255,651,913,986,0.079956188
84006001409900,182,1383,1201,1480,1446,-0.022972973
84006001410000,69,1197,1128,1375,1674,0.217454545
84006001410100,427,992,565,1181,1019,-0.137171888
84006001410200,655,1146,491,1030,1062,0.031067961
84006001410300,622,946,324,1090,1216,0.11559633
84006001410400,516,1397,881,1241,1414,0.139403707
84006001410500,875,961,86,411,599,0.457420925
84006001420100,306,870,564,1817,2065,0.136488718
84006001420200,721,1240,519,1338,1561,0.166666667
84006001420300,994,1955,961,1466,1542,0.051841746
84006001420400,1177,1177,0,1648,1700,0.031553398
84006001420500,480,934,454,1330,1640,0.233082707
84006001420600,283,1219,936,1631,1491,-0.08583691
84006001421100,67,860,793,2001,2816,0.407296352
84006001421200,212,1521,1309,1330,1500,0.127819549
84006001421300,398,1638,1240,1555,1628,0.046945338
84006001421400,103,650,547,2001,1808,-0.096451774
84006001421500,270,1579,1309,1681,2503,0.488994646
84006001421600,380,1583,1203,1167,1764,0.511568123
84006001421700,997,1605,608,1538,1521,-0.011053316
84006001421800,300,938,638,1384,1691,0.221820809
84006001421900,581,1711,1130,1471,1586,0.07817811
84006001422000,702,884,182,686,1637,1.386297376
84006001422100,523,1142,619,974,1372,0.40862423
84006001422200,957,1613,656,1047,1408,0.344794651
84006001422300,1215,1753,538,1334,1531,0.147676162
84006001422400,1866,2123,257,1329,1499,0.127915726
84006001422500,1171,1454,283,1272,1523,0.197327044
84006001422600,0,21,21,-666666666,-666666666,0
84006001422700,878,1019,141,1314,1416,0.077625571
84006001422800,1356,1389,33,1106,1284,0.160940325
84006001422900,1913,1958,45,1166,1389,0.191252144
84006001423000,1104,1953,849,1243,1693,0.362027353
84006001423100,1317,2011,694,992,1296,0.306451613
84006001423200,770,1130,360,1172,1375,0.173208191
84006001423300,798,1665,867,1009,1295,0.283448959
84006001423400,1092,2084,992,1078,1365,0.266233766
84006001423500,1060,1473,413,1134,1124,-0.008818342
84006001423601,650,1170,520,1227,1573,0.28198859
84006001423602,1963,2262,299,1413,1384,-0.020523708
84006001423700,775,1359,584,1107,1272,0.149051491
84006001423800,281,1289,1008,1486,2093,0.408479139
84006001423901,531,859,328,952,1185,0.244747899
84006001423902,495,726,231,1262,1697,0.344690967
84006001424001,1112,1543,431,1159,1380,0.190681622
84006001424002,530,958,428,1007,1211,0.202581927
84006001425101,597,1161,564,1408,1530,0.086647727
84006001425102,1221,1798,577,1868,2151,0.151498929
84006001425103,851,1380,529,1680,2056,0.223809524
84006001425104,1304,1924,620,1248,1328,0.064102564
84006001426100,182,2216,2034,2001,2824,0.411294353
84006001426200,266,1709,1443,1939,2208,0.138731305
84006001427100,362,1401,1039,1307,1677,0.283091048
84006001427200,993,1663,670,1279,1337,0.045347928
84006001427300,974,1936,962,1122,1265,0.12745098
84006001427600,1543,1838,295,1263,1575,0.247030879
84006001427700,1474,2284,810,1316,1528,0.161094225
84006001427800,1190,2009,819,1122,1416,0.262032086
84006001427900,1524,2211,687,1202,1473,0.225457571
84006001428000,1173,1390,217,1104,1319,0.194746377
84006001428100,914,1943,1029,1335,1298,-0.027715356
84006001428200,1168,2708,1540,1558,1555,-0.001925546
84006001428301,566,2509,1943,2001,2025,0.011994003
84006001428302,584,2662,2078,2001,1935,-0.032983508
84006001428400,1360,1852,492,1185,1406,0.18649789
84006001428500,924,1428,504,1455,1604,0.102405498
84006001428600,735,1551,816,1423,2039,0.432888264
84006001428700,849,1293,444,643,1085,0.687402799
84006001430101,288,2248,1960,2001,2949,0.473763118
84006001430102,143,867,724,979,1957,0.99897855
84006001430200,135,2506,2371,2001,2244,0.12143928
84006001430300,241,1292,1051,1326,1946,0.467571644
84006001430400,73,729,656,891,2205,1.474747475
84006001430500,767,2031,1264,1294,1247,-0.036321484
84006001430600,437,2188,1751,1699,1783,0.049440848
84006001430700,313,1329,1016,1314,1843,0.402587519
84006001430800,971,2204,1233,1476,1376,-0.067750678
84006001430900,1418,1801,383,1216,1418,0.166118421
84006001431000,698,1102,404,1134,1485,0.30952381
84006001431100,1069,1374,305,1203,1286,0.068994181
84006001431200,1165,2489,1324,1385,1504,0.085920578
84006001432100,412,1484,1072,1015,1425,0.403940887
84006001432200,965,1707,742,1136,1404,0.235915493
84006001432300,646,1709,1063,1001,1176,0.174825175
84006001432400,1100,1852,752,1334,1399,0.048725637
84006001432501,716,1469,753,1107,1364,0.232158988
84006001432502,719,1522,803,1112,1402,0.260791367
84006001432600,2141,3036,895,1135,1265,0.114537445
84006001432700,335,1064,729,1389,1536,0.105831533
84006001432800,222,1352,1130,1250,1230,-0.016
84006001433000,440,1342,902,1689,1654,-0.020722321
84006001433102,401,1329,928,1242,1389,0.118357488
84006001433103,1249,1590,341,1062,1158,0.09039548
84006001433104,1294,1858,564,1129,1321,0.170062002
84006001433200,1749,2774,1025,1156,1194,0.032871972
84006001433300,513,2271,1758,1623,1734,0.068391867
84006001433400,520,2292,1772,1459,1720,0.17888965
84006001433500,227,1405,1178,1196,1663,0.390468227
84006001433600,1092,2158,1066,1363,1216,-0.10785033
84006001433700,661,1040,379,1109,1231,0.110009017
84006001433800,1521,2571,1050,1212,1363,0.124587459
84006001433900,2032,2398,366,1068,1220,0.142322097
84006001434000,1226,1821,595,957,1119,0.169278997
84006001435102,417,1571,1154,1750,1842,0.052571429
84006001435103,150,2206,2056,1899,2943,0.549763033
84006001435104,1625,2038,413,1349,1561,0.157153447
84006001435200,275,1443,1168,1366,1338,-0.020497804
84006001435300,909,1563,654,1207,1349,0.117647059
84006001435400,1321,1761,440,1132,1301,0.149293286
84006001435500,981,1412,431,1160,1231,0.061206897
84006001435601,1224,1627,403,1139,1308,0.148375768
84006001435602,1027,1636,609,1126,1354,0.202486679
84006001435700,426,1385,959,1391,1465,0.053199137
84006001435800,374,1645,1271,1567,1740,0.110402042
84006001435900,379,1611,1232,1883,1774,-0.057886352
84006001436000,288,1407,1119,1991,1796,-0.097940733
84006001436100,778,1819,1041,1040,1142,0.098076923
84006001436200,1073,1275,202,1202,1194,-0.006655574
84006001436300,1524,2604,1080,1207,1426,0.181441591
84006001436401,1636,3013,1377,1182,1439,0.217428088
84006001436402,112,1021,909,2001,2439,0.218890555
84006001436500,1293,1715,422,1199,1400,0.1676397
84006001436601,1195,1854,659,1180,1332,0.128813559
84006001436602,1339,1667,328,1123,1228,0.093499555
84006001436700,467,1021,554,1411,1787,0.266477675
84006001436800,723,1338,615,1322,1467,0.1096823
84006001436900,1023,1784,761,1172,1334,0.138225256
84006001437000,259,1242,983,1658,1551,-0.064535585
84006001437101,258,1907,1649,1679,2175,0.295413937
84006001437102,665,1391,726,1289,1299,0.007757952
84006001437200,900,2301,1401,1330,1733,0.303007519
84006001437300,404,915,511,1229,1389,0.130187144
84006001437400,211,907,696,1517,1944,0.281476599
84006001437500,948,1177,229,1255,1375,0.09561753
84006001437600,417,890,473,1162,1354,0.165232358
84006001437701,808,1059,251,1188,1252,0.053872054
84006001437702,1010,1094,84,1157,1281,0.107173725
84006001437800,391,1373,982,1586,1703,0.073770492
84006001437900,365,660,295,1202,1402,0.166389351
84006001438000,373,1097,724,1422,1844,0.29676512
84006001438100,537,2057,1520,1314,2125,0.617199391
84006001438201,289,1187,898,1200,1514,0.261666667
84006001438203,348,1212,864,1753,1304,-0.256132345
84006001438204,364,1809,1445,1623,1757,0.082563155
84006001438300,293,890,597,1971,1949,-0.011161847
84006001438400,114,693,579,1854,1232,-0.335490831
84006001440100,518,1002,484,1445,2023,0.4
84006001440200,814,1503,689,1219,1470,0.205906481
84006001440301,528,2081,1553,1055,1449,0.373459716
84006001440304,412,1268,856,1458,1646,0.128943759
84006001440305,178,971,793,2001,2347,0.172913543
84006001440306,433,1032,599,1904,1906,0.00105042
84006001440307,375,1492,1117,972,1607,0.653292181
84006001440308,902,1917,1015,1128,1693,0.500886525
84006001440331,476,919,443,1390,1629,0.171942446
84006001440332,108,879,771,2001,3235,0.616691654
84006001440333,131,812,681,2001,2288,0.143428286
84006001440334,192,1051,859,1592,2033,0.27701005
84006001440335,963,2196,1233,1500,1789,0.192666667
84006001440336,659,1442,783,1427,1872,0.311843027
84006001441100,377,1584,1207,1417,1601,0.1298518
84006001441200,972,2542,1570,1273,1723,0.353495679
84006001441301,635,1168,533,1695,2124,0.253097345
84006001441302,537,1822,1285,1446,1829,0.264868603
84006001441401,762,2325,1563,1168,1975,0.690924658
84006001441402,396,1644,1248,1620,2317,0.430246914
84006001441501,255,1781,1526,2001,1971,-0.014992504
84006001441503,505,2020,1515,1699,2377,0.39905827
84006001441521,412,1799,1387,2001,2322,0.16041979
84006001441522,321,1481,1160,1791,2094,0.169179229
84006001441523,748,1419,671,1659,2002,0.206751055
84006001441524,495,1302,807,1449,2034,0.403726708
84006001441601,201,1455,1254,1754,2135,0.217217788
84006001441602,1099,2263,1164,1323,1786,0.349962207
84006001441700,1187,2621,1434,1342,1462,0.089418778
84006001441800,973,2314,1341,1517,1754,0.1562294
84006001441921,813,1229,416,1847,2198,0.190037899
84006001441923,2235,2360,125,1333,1750,0.312828207
84006001441924,1041,2651,1610,1520,2019,0.328289474
84006001441925,2320,2837,517,1762,2051,0.164018161
84006001441926,1184,1448,264,1229,1618,0.316517494
84006001441927,1380,1790,410,1488,2064,0.387096774
84006001442000,76,1034,958,2001,1931,-0.034982509
84006001442100,188,1616,1428,2001,2218,0.108445777
84006001442200,287,2140,1853,2001,2597,0.297851074
84006001442301,705,1516,811,1321,1630,0.233913702
84006001442302,1385,2065,680,1246,1424,0.142857143
84006001442400,648,1975,1327,1626,1878,0.15498155
84006001442500,952,2219,1267,1424,1559,0.094803371
84006001442601,352,1301,949,1708,1790,0.048009368
84006001442602,719,1618,899,1323,1511,0.142101285
84006001442700,330,1037,707,1395,2089,0.497491039
84006001442800,229,925,696,1492,2235,0.497989276
84006001442900,749,2354,1605,1607,1985,0.235220909
84006001443001,274,833,559,1741,2175,0.249282022
84006001443002,564,1887,1323,1771,1974,0.114624506
84006001443102,180,1531,1351,2001,3071,0.534732634
84006001443103,95,1234,1139,2001,2800,0.39930035
84006001443104,565,1743,1178,1640,1822,0.11097561
84006001443105,89,1436,1347,2001,3019,0.508745627
84006001443200,62,1180,1118,2001,3500,0.749125437
84006001443301,174,1215,1041,1341,2470,0.841909023
84006001443321,668,1156,488,1482,1676,0.130904184
84006001443322,123,904,781,1867,2477,0.32672737
84006001444100,381,2531,2150,490,1614,2.293877551
84006001444200,372,1897,1525,1491,2112,0.416498994
84006001444301,291,1172,881,1179,1493,0.266327396
84006001444302,507,1254,747,1245,1449,0.163855422
84006001444400,645,1549,904,1404,1715,0.221509972
84006001444500,1209,2038,829,1533,1743,0.136986301
84006001444601,225,1526,1301,2001,2354,0.176411794
84006001444602,437,1555,1118,1712,1852,0.081775701
84006001450101,1227,1860,633,1918,2278,0.187695516
84006001450102,531,1360,829,1698,2305,0.357479388
84006001450200,1603,2446,843,1636,2001,0.223105134
84006001450300,486,1749,1263,1825,2274,0.246027397
84006001450400,439,2087,1648,1887,1551,-0.178060413
84006001450501,378,1307,929,1454,2109,0.450481431
84006001450502,209,1803,1594,1823,2402,0.317608338
84006001450601,180,1351,1171,1385,1642,0.185559567
84006001450602,970,3349,2379,1664,2101,0.262620192
84006001450603,293,1630,1337,2001,2418,0.208395802
84006001450604,426,1801,1375,1385,1861,0.34368231
84006001450605,310,1490,1180,1697,2018,0.189157336
84006001450606,304,2059,1755,2001,1937,-0.031984008
84006001450607,1441,2290,849,1391,1455,0.046010065
84006001450701,508,2892,2384,1660,1919,0.156024096
84006001450741,761,1924,1163,1465,1873,0.278498294
84006001450742,379,1868,1489,1783,1980,0.110487942
84006001450743,1387,2103,716,1653,2090,0.264367816
84006001450744,487,1701,1214,1447,2228,0.539737388
84006001450745,664,2209,1545,1813,1821,0.004412576
84006001450746,319,1336,1017,1909,1679,-0.120481928
84006001450750,1096,2028,932,1608,1791,0.11380597
84006001450751,261,2227,1966,2001,2846,0.422288856
84006001450752,211,1610,1399,1968,2684,0.363821138
84006001451101,403,2455,2052,1824,2025,0.110197368
84006001451102,35,1393,1358,1909,-666666666,-349223.9785
84006001451201,769,2608,1839,1371,1823,0.32968636
84006001451202,144,1515,1371,1818,2130,0.171617162
84006001451300,521,2351,1830,1827,2154,0.178981938
84006001451401,1005,2397,1392,1393,1658,0.190236899
84006001451403,150,770,620,1208,2151,0.780629139
84006001451404,1204,2033,829,1265,1634,0.291699605
84006001451501,632,1773,1141,1051,924,-0.120837298
84006001451503,631,2129,1498,982,1248,0.270875764
84006001451504,189,623,434,1453,2275,0.565726084
84006001451505,145,1189,1044,2001,2282,0.140429785
84006001451506,607,1115,508,1426,1645,0.153576438
84006001451601,506,1979,1473,1396,1533,0.098137536
84006001451602,1276,2891,1615,1368,1540,0.125730994
84006001451701,256,1047,791,1879,2228,0.185737094
84006001451703,228,1371,1143,1827,2179,0.192665572
84006001451704,582,1711,1129,1192,1516,0.271812081
84006001981900,24,24,0,1486,1857,0.249663526
84006001982000,7,29,22,-666666666,-666666666,0
84006001983200,32,310,278,1824,2536,0.390350877
84006001990000,0,0,0,-666666666,-666666666,0
84006013301000,344,1874,1530,1038,1431,0.378612717
84006013302005,906,2320,1414,920,1072,0.165217391
84006013302006,257,1249,992,1619,1689,0.043236566
84006013302007,687,2022,1335,1668,1540,-0.076738609
84006013302008,649,2172,1523,1265,1427,0.128063241
84006013302009,876,2017,1141,1887,2003,0.061473238
84006013302010,385,3213,2828,1732,2106,0.215935335
84006013303102,634,2468,1834,1213,1616,0.33223413
84006013303103,1552,3594,2042,1189,1738,0.461732548
84006013303201,1026,3060,2034,1993,1957,-0.018063221
84006013303202,575,2289,1714,2001,1849,-0.075962019
84006013303203,878,2927,2049,1932,2069,0.070910973
84006013303204,463,1590,1127,1134,1761,0.552910053
84006013303205,564,3282,2718,1932,2213,0.145445135
84006013304001,310,1412,1102,2001,2556,0.277361319
84006013304002,150,451,301,1393,1097,-0.212491027
84006013304003,345,1503,1158,2001,1965,-0.017991004
84006013304004,296,1595,1299,2001,2207,0.102948526
84006013304005,538,2198,1660,2001,2248,0.123438281
84006013305000,1715,2272,557,1073,1088,0.013979497
84006013306002,196,1036,840,1710,1333,-0.220467836
84006013306003,735,1695,960,1170,1199,0.024786325
84006013306004,534,1202,668,1274,1389,0.090266876
84006013307101,484,1443,959,1077,1409,0.308263695
84006013307102,939,1688,749,1246,1228,-0.014446228
84006013307201,527,1114,587,987,1042,0.055724417
84006013307202,1310,1489,179,1072,1057,-0.013992537
84006013307204,281,1239,958,1755,1650,-0.05982906
84006013307205,1471,2493,1022,1101,1305,0.185286104
84006013308001,760,2431,1671,1624,1544,-0.049261084
84006013308002,241,1397,1156,2001,2064,0.031484258
84006013309000,592,1251,659,1037,1190,0.147540984
84006013310000,976,1703,727,1085,1263,0.1640553
84006013311000,715,1484,769,1303,1353,0.038372985
84006013312000,519,781,262,931,566,-0.392051557
84006013313101,1339,2589,1250,1206,1220,0.011608624
84006013313102,670,1472,802,1461,1505,0.030116359
84006013313103,947,2640,1693,1297,1690,0.303006939
84006013313203,275,914,639,1682,1758,0.045184304
84006013313204,738,1708,970,1095,1324,0.20913242
84006013313205,119,506,387,1713,1723,0.005837712
84006013313206,765,1592,827,1243,1426,0.147224457
84006013314102,507,1662,1155,1136,1530,0.346830986
84006013314103,991,1753,762,1013,1317,0.300098717
84006013314104,1281,2447,1166,975,1218,0.249230769
84006013314200,653,1730,1077,1533,1433,-0.065231572
84006013315000,247,1215,968,1598,1699,0.063204005
84006013316000,411,465,54,772,937,0.21373057
84006013317000,702,1074,372,1230,1345,0.093495935
84006013318000,703,1475,772,1052,1231,0.170152091
84006013319000,1229,3162,1933,1219,1302,0.068088597
84006013320001,445,1254,809,1305,1377,0.055172414
84006013320003,145,1064,919,1736,2326,0.339861751
84006013320004,839,2542,1703,1519,1691,0.11323239
84006013321101,949,2579,1630,1333,1897,0.423105776
84006013321102,398,2675,2277,1696,2500,0.474056604
84006013321103,240,1783,1543,1462,1737,0.188098495
84006013321200,1313,2179,866,1376,1597,0.160610465
84006013322000,714,2456,1742,1675,2274,0.35761194
84006013323000,368,1714,1346,1664,1963,0.1796875
84006013324001,2444,2994,550,1316,1447,0.099544073
84006013324002,1558,2420,862,1417,1578,0.113620325
84006013325000,725,2161,1436,1182,1465,0.239424704
84006013326000,278,1345,1067,1966,1947,-0.009664293
84006013327000,1085,2837,1752,1153,1244,0.078924545
84006013328000,1375,1455,80,1065,1252,0.175586854
84006013329000,587,2162,1575,1413,1470,0.040339703
84006013330000,571,1878,1307,1634,1796,0.099143207
84006013331000,1190,2792,1602,1112,1391,0.250899281
84006013332000,726,2899,2173,1758,1421,-0.191695108
84006013333101,521,1512,991,1240,1486,0.198387097
84006013333102,407,1508,1101,1139,1476,0.295873573
84006013333200,716,2256,1540,1759,1973,0.121660034
84006013334001,723,1549,826,1259,1268,0.007148531
84006013334004,1560,3101,1541,1155,1481,0.282251082
84006013334006,292,1676,1384,2001,2677,0.337831084
84006013334200,636,2781,2145,2001,2203,0.100949525
84006013335000,445,1236,791,1539,1728,0.122807018
84006013336101,1294,1506,212,1045,1341,0.283253589
84006013336102,2351,2629,278,1087,1225,0.126954922
84006013336201,498,1198,700,1475,1369,-0.071864407
84006013336202,1479,1696,217,1066,1148,0.076923077
84006013337100,277,1244,967,1313,1702,0.296268088
84006013337200,1465,3023,1558,1237,1430,0.156022635
84006013337300,380,2279,1899,1560,1670,0.070512821
84006013338101,833,1755,922,1266,1370,0.082148499
84006013338102,157,1373,1216,1876,2198,0.171641791
84006013338201,198,1398,1200,1389,1764,0.269978402
84006013338203,1598,2663,1065,1522,1783,0.171484888
84006013338204,1228,2692,1464,1625,2060,0.267692308
84006013338301,141,1071,930,2001,1919,-0.04097951
84006013338302,291,2119,1828,1429,2297,0.607417775
84006013339001,1721,1821,100,1279,1682,0.315089914
84006013339002,2752,3530,778,1371,1685,0.229029905
84006013340001,1037,2389,1352,1316,1645,0.25
84006013340002,689,2936,2247,1595,2140,0.34169279
84006013341000,784,2108,1324,1408,1658,0.177556818
84006013343001,1134,2094,960,1332,1638,0.22972973
84006013343002,613,1894,1281,1670,1772,0.061077844
84006013343003,242,1486,1244,1283,1508,0.175370226
84006013345101,516,1851,1335,1494,1857,0.242971888
84006013345102,142,1217,1075,2001,2411,0.204897551
84006013345103,311,1764,1453,1654,1656,0.00120919
84006013345105,429,2246,1817,2001,2173,0.085957021
84006013345108,785,3132,2347,2001,2200,0.099450275
84006013345111,840,1865,1025,1435,1903,0.326132404
84006013345112,1047,2078,1031,1459,1891,0.296093215
84006013345113,128,1447,1319,2001,3147,0.572713643
84006013345114,251,2556,2305,2001,3190,0.594202899
84006013345115,469,1895,1426,1841,2421,0.315046171
84006013345116,143,898,755,2001,3222,0.610194903
84006013345202,1358,3119,1761,1660,1938,0.16746988
84006013345203,736,2656,1920,1845,1984,0.075338753
84006013345204,83,1252,1169,1158,3501,2.023316062
84006013346101,145,1301,1156,2001,3184,0.591204398
84006013346102,171,1998,1827,2001,2669,0.333833083
84006013346201,241,2751,2510,2001,2889,0.443778111
84006013346203,74,1377,1303,2001,3130,0.564217891
84006013346204,264,2520,2256,2001,2025,0.011994003
84006013347000,346,2382,2036,1216,1440,0.184210526
84006013348000,235,1668,1433,2001,2012,0.005497251
84006013349000,873,2041,1168,1616,1570,-0.028465347
84006013350000,1173,2591,1418,1381,1812,0.312092686
84006013351101,157,1926,1769,1376,1031,-0.250726744
84006013351102,323,2697,2374,1029,1231,0.196307094
84006013351103,61,1276,1215,1521,1379,-0.093359632
84006013351200,95,2132,2037,2001,3501,0.749625187
84006013352101,71,797,726,2001,2331,0.164917541
84006013352102,127,1788,1661,2001,2433,0.215892054
84006013352201,634,2342,1708,1536,1793,0.167317708
84006013352202,221,1032,811,2001,2246,0.122438781
84006013353001,96,1317,1221,1850,-666666666,-360361.36
84006013353002,139,1533,1394,2001,2463,0.230884558
84006013354001,54,731,677,1790,-666666666,-372440.4782
84006013354002,507,2595,2088,1440,-666666666,-462963.9625
84006013355107,311,1704,1393,1652,2104,0.273607748
84006013355108,963,3725,2762,2001,2225,0.111944028
84006013355109,331,2218,1887,1200,1817,0.514166667
84006013355110,363,1112,749,1897,2049,0.080126516
84006013355111,502,1923,1421,2001,2074,0.036481759
84006013355112,193,2094,1901,1830,-666666666,-364299.7246
84006013355113,179,1707,1528,2001,3501,0.749625187
84006013355114,601,3461,2860,1958,2539,0.296731359
84006013355115,1441,2514,1073,1448,1749,0.207872928
84006013355116,399,2167,1768,2001,2546,0.272363818
84006013355117,255,1902,1647,2001,3226,0.612193903
84006013355200,1147,2692,1545,1429,1973,0.380685794
84006013355301,437,2870,2433,1596,2125,0.331453634
84006013355302,110,1198,1088,2001,1992,-0.004497751
84006013355304,341,3165,2824,1465,2134,0.45665529
84006013355306,196,1826,1630,1481,2054,0.386900743
84006013356001,214,1240,1026,1568,1448,-0.076530612
84006013356002,338,1892,1554,1771,1655,-0.065499718
84006013357000,812,1482,670,911,1136,0.246981339
84006013358000,1012,2073,1061,963,1148,0.192107996
84006013359102,628,1892,1264,1304,1575,0.207822086
84006013359103,811,1984,1173,1065,1225,0.150234742
84006013359104,255,889,634,1665,1612,-0.031831832
84006013359105,263,1522,1259,1767,2288,0.294850028
84006013359202,418,2210,1792,2001,1894,-0.053473263
84006013359203,496,2291,1795,1818,1781,-0.020352035
84006013359204,203,1487,1284,1204,1431,0.188538206
84006013360101,346,1654,1308,1820,1562,-0.141758242
84006013360102,193,1489,1296,2001,2458,0.228385807
84006013360200,733,1744,1011,1104,1351,0.223731884
84006013361000,702,1739,1037,1084,1221,0.126383764
84006013362000,268,1213,945,1675,1401,-0.16358209
84006013363000,882,2729,1847,1327,1508,0.13639789
84006013364002,680,1810,1130,1121,1531,0.365744871
84006013365002,1026,1574,548,974,1135,0.165297741
84006013365003,1778,2248,470,1388,1524,0.097982709
84006013366001,545,1324,779,1257,1407,0.119331742
84006013366002,1079,1685,606,1163,1215,0.044711952
84006013367100,867,1944,1077,952,1070,0.12394958
84006013367200,965,1737,772,941,1096,0.164718385
84006013368001,765,1320,555,1067,1095,0.026241799
84006013368002,586,948,362,1254,1142,-0.089314195
84006013369001,1764,2426,662,1002,1077,0.074850299
84006013369002,462,980,518,1156,1139,-0.014705882
84006013370000,345,1112,767,1211,1618,0.336085879
84006013371000,952,1965,1013,1226,1322,0.078303426
84006013372000,745,2235,1490,1283,1218,-0.05066251
84006013373000,424,1112,688,939,1273,0.355697551
84006013374000,1039,1702,663,1270,1016,-0.2
84006013375000,746,1139,393,1049,1185,0.129647283
84006013376000,1223,1757,534,773,970,0.254851229
84006013377000,1437,2177,740,997,995,-0.002006018
84006013378000,707,1699,992,1183,1350,0.141166526
84006013379000,1232,1893,661,934,1171,0.253747323
84006013380000,1444,2878,1434,1213,1519,0.252267106
84006013381000,1280,2028,748,1176,1215,0.033163265
84006013382000,1765,2724,959,1052,1109,0.05418251
84006013383000,847,1949,1102,1197,1487,0.242272348
84006013384000,255,1626,1371,2001,1820,-0.090454773
84006013385100,125,1121,996,2001,2532,0.265367316
84006013385200,120,527,407,2001,2350,0.174412794
84006013386000,1010,1475,465,1261,1473,0.168120539
84006013387000,556,1078,522,1447,1648,0.138908086
84006013388000,547,1090,543,1367,1660,0.214337966
84006013389100,521,859,338,1406,1551,0.103129445
84006013389200,666,720,54,1238,1357,0.096122779
84006013390100,142,915,773,1375,2500,0.818181818
84006013390200,91,735,644,1897,2227,0.173958882
84006013391000,207,1121,914,1972,1794,-0.090263692
84006013392000,121,1165,1044,2001,2450,0.224387806
84006013392200,1216,3205,1989,1614,1714,0.061957869
84006013392300,198,888,690,725,976,0.346206897
84006013990000,0,0,0,-666666666,-666666666,0
84006041101100,125,1064,939,1750,2328,0.330285714
84006041101200,161,1122,961,970,2494,1.571134021
84006041102100,204,985,781,2001,2000,-0.00049975
84006041102202,519,2235,1716,1792,1813,0.01171875
84006041102203,1409,2188,779,1300,1658,0.275384615
84006041103100,336,2881,2545,2001,1767,-0.116941529
84006041103200,976,2774,1798,1531,1672,0.092096669
84006041104101,948,3146,2198,1544,1998,0.294041451
84006041104102,1193,2147,954,1502,1696,0.129161119
84006041104200,874,2528,1654,1665,2084,0.251651652
84006041104300,87,684,597,2001,2786,0.392303848
84006041105000,867,2685,1818,1442,1371,-0.049237171
84006041106001,1234,2118,884,1746,2155,0.234249714
84006041106002,564,2127,1563,1895,1695,-0.105540897
84006041107000,388,2393,2005,2001,2347,0.172913543
84006041108100,411,2739,2328,2001,2563,0.28085957
84006041108200,1308,2878,1570,1322,1430,0.081694402
84006041109001,982,1726,744,1437,1443,0.004175365
84006041109002,618,1803,1185,1439,1505,0.045865184
84006041110100,929,2358,1429,1236,1409,0.139967638
84006041110200,175,2163,1988,2001,2676,0.337331334
84006041111000,1924,2743,819,1359,1575,0.158940397
84006041112100,885,1850,965,1237,1489,0.203718674
84006041112201,1566,1680,114,1395,1512,0.083870968
84006041112202,725,1267,542,1170,1684,0.439316239
84006041113000,440,1593,1153,1691,1679,-0.007096393
84006041114100,594,2211,1617,1681,1875,0.115407496
84006041114200,520,1376,856,1419,1563,0.101479915
84006041115000,355,2796,2441,1796,1813,0.009465479
84006041116000,411,1277,866,1581,1921,0.215053763
84006041117000,687,2048,1361,1396,1519,0.088108883
84006041118100,79,772,693,2001,2266,0.132433783
84006041119100,550,1987,1437,1328,1500,0.129518072
84006041119201,1320,1888,568,1719,1795,0.044211751
84006041119202,125,1221,1096,2001,3384,0.691154423
84006041120000,1175,2838,1663,1563,1823,0.166346769
84006041121100,763,2100,1337,1662,1938,0.166064982
84006041121200,1038,2445,1407,1769,2259,0.276992651
84006041122000,0,0,0,-666666666,-666666666,0
84006041123000,176,919,743,2001,2408,0.203398301
84006041124100,871,2214,1343,1750,2040,0.165714286
84006041124200,844,2550,1706,2001,2421,0.209895052
84006041125000,1127,2025,898,1680,1585,-0.056547619
84006041126100,614,2272,1658,2001,2444,0.221389305
84006041126200,817,1952,1135,1612,1738,0.078163772
84006041127000,588,2107,1519,1859,1911,0.027972028
84006041128100,713,2737,2024,2001,2657,0.327836082
84006041128200,435,1858,1423,1830,2142,0.170491803
84006041129000,890,1075,185,1343,1391,0.035740879
84006041130201,946,1944,998,1970,2474,0.255837563
84006041130202,1179,2427,1248,2001,1887,-0.056971514
84006041131100,137,407,270,1833,1775,-0.031642117
84006041132100,304,868,564,1378,1874,0.359941945
84006041132200,489,860,371,1304,1272,-0.024539877
84006041133000,605,1349,744,1303,1195,-0.082885649
84006041990100,0,0,0,-666666666,-666666666,0
84006055200201,664,1308,644,1029,1301,0.264334305
84006055200202,932,1243,311,943,1078,0.143160127
84006055200203,512,851,339,1097,1124,0.02461258
84006055200301,921,1730,809,1181,1341,0.135478408
84006055200302,245,936,691,1719,1726,0.004072135
84006055200400,653,1552,899,1261,1730,0.371927042
84006055200501,839,1651,812,1236,1391,0.125404531
84006055200503,505,678,173,1088,1234,0.134191176
84006055200504,1190,2167,977,1417,1458,0.028934368
84006055200505,814,1058,244,1396,1642,0.176217765
84006055200601,475,1596,1121,1572,2079,0.322519084
84006055200602,696,1767,1071,981,1385,0.411824669
84006055200703,81,1057,976,1767,2293,0.297679683
84006055200704,736,1643,907,1047,1333,0.273161414
84006055200705,470,962,492,1288,1485,0.152950311
84006055200706,184,1137,953,1796,2451,0.364699332
84006055200707,630,1287,657,1795,1663,-0.073537604
84006055200802,1238,2199,961,1297,1579,0.217424827
84006055200803,232,849,617,968,926,-0.04338843
84006055200804,840,1703,863,1189,1333,0.121110177
84006055200900,45,45,0,838,-666666666,-795545.9475
84006055201003,456,1440,984,1420,1218,-0.142253521
84006055201004,343,1959,1616,1000,1429,0.429
84006055201005,92,636,544,-666666666,2058,-1.000003087
84006055201006,221,912,691,1995,1693,-0.151378446
84006055201007,247,1090,843,1979,1858,-0.061141991
84006055201101,79,794,715,2001,2658,0.328335832
84006055201102,216,756,540,861,1125,0.306620209
84006055201200,334,1968,1634,1438,1253,-0.128650904
84006055201300,436,1372,936,1674,2100,0.254480287
84006055201401,197,1257,1060,1432,2762,0.92877095
84006055201402,156,1190,1034,1056,2275,1.154356061
84006055201403,74,264,190,894,1578,0.765100671
84006055201500,232,798,566,1770,1875,0.059322034
84006055201601,556,1016,460,1445,1566,0.083737024
84006055201602,503,1520,1017,1546,1420,-0.081500647
84006055201700,752,1698,946,1081,1346,0.245143386
84006055201800,144,741,597,1431,1111,-0.223619846
84006055201900,199,538,339,953,1228,0.288562434
84006055202000,825,2007,1182,1211,1153,-0.047894302
84006075010100,1845,2059,214,1392,1653,0.1875
84006075010200,1704,2547,843,1670,2249,0.346706587
84006075010300,1500,2034,534,2001,1893,-0.053973013
84006075010400,1643,2501,858,1955,2229,0.140153453
84006075010500,1278,1614,336,2001,2326,0.162418791
84006075010600,1583,1812,229,1039,995,-0.042348412
84006075010700,2286,2496,210,606,628,0.03630363
84006075010800,2003,2425,422,1447,1509,0.04284727
84006075010900,2117,2717,600,1485,2066,0.391245791
84006075011000,2136,2624,488,1166,1598,0.370497427
84006075011100,2784,3073,289,1214,1419,0.168863262
84006075011200,1340,1916,576,1495,1615,0.080267559
84006075011300,1362,1534,172,532,907,0.704887218
84006075011700,1013,1061,48,871,1043,0.197474168
84006075011800,703,708,5,659,622,-0.056145675
84006075011901,1034,1488,454,1143,1627,0.423447069
84006075011902,1725,1835,110,1302,1498,0.150537634
84006075012000,2528,2594,66,1025,1198,0.168780488
84006075012100,2001,2133,132,1151,1448,0.25803649
84006075012201,2800,2937,137,1045,1342,0.284210526
84006075012202,1492,1563,71,795,988,0.242767296
84006075012301,1332,1340,8,577,704,0.220103986
84006075012302,1896,1906,10,1024,1426,0.392578125
84006075012401,2664,2664,0,787,832,0.057179161
84006075012402,2174,2326,152,879,1019,0.1592719
84006075012501,2117,2179,62,573,592,0.033158813
84006075012502,2180,2201,21,506,350,-0.308300395
84006075012601,1261,1518,257,1747,1930,0.104751002
84006075012602,1359,1672,313,1844,2096,0.136659436
84006075012700,1603,2187,584,1625,2193,0.349538462
84006075012800,1610,2371,761,1638,2278,0.390720391
84006075012901,1148,1512,364,1832,1793,-0.02128821
84006075012902,1611,2057,446,1615,1908,0.181424149
84006075013000,1925,2562,637,1890,2102,0.112169312
84006075013101,2096,2555,459,1852,2291,0.237041037
84006075013102,1268,1641,373,1828,2377,0.300328228
84006075013200,1440,2229,789,2001,2335,0.166916542
84006075013300,1008,1892,884,1936,1912,-0.012396694
84006075013400,1364,2032,668,1614,2229,0.381040892
84006075013500,1248,1604,356,1491,1727,0.158283032
84006075015100,1066,1488,422,1726,1882,0.090382387
84006075015200,1906,2431,525,1429,1653,0.156752974
84006075015300,646,950,304,1447,2155,0.489288182
84006075015400,2085,2941,856,1518,2085,0.373517787
84006075015500,1962,2280,318,1355,1333,-0.016236162
84006075015600,1152,1462,310,1349,1674,0.240919199
84006075015700,1906,2677,771,1430,2058,0.439160839
84006075015801,1237,1727,490,1177,1109,-0.057774002
84006075015802,1229,1564,335,1554,1401,-0.098455598
84006075015900,1646,2116,470,1562,1714,0.09731114
84006075016000,1264,1737,473,1209,1270,0.050454921
84006075016100,2415,2602,187,517,758,0.46615087
84006075016200,1552,1784,232,1274,1479,0.160910518
84006075016300,1572,2037,465,1227,1663,0.355338223
84006075016400,1489,1874,385,1580,1901,0.203164557
84006075016500,1799,2383,584,1520,1681,0.105921053
84006075016600,2041,2494,453,1654,1781,0.076783555
84006075016700,1710,2422,712,1619,1861,0.149474985
84006075016801,1278,1602,324,1573,1638,0.041322314
84006075016802,1437,1794,357,1372,1348,-0.017492711
84006075016900,1112,1532,420,1474,1666,0.130257802
84006075017000,966,2165,1199,1778,2130,0.197975253
84006075017101,1087,1776,689,1753,1962,0.119224187
84006075017102,1037,1671,634,1831,2157,0.178044784
84006075017601,4096,4430,334,745,824,0.106040268
84006075017700,639,758,119,1507,1653,0.096881221
84006075017801,1844,2242,398,307,296,-0.035830619
84006075017802,1741,2286,545,1476,1141,-0.22696477
84006075017902,602,602,0,1753,1856,0.058756418
84006075018000,741,1314,573,1591,2591,0.628535512
84006075020100,2549,3115,566,831,1009,0.214199759
84006075020200,2629,3189,560,1264,1359,0.075158228
84006075020300,1273,1738,465,1664,1698,0.020432692
84006075020401,695,1595,900,2001,2149,0.073963018
84006075020402,1893,2501,608,1574,1895,0.203939009
84006075020500,868,1401,533,1624,1939,0.193965517
84006075020600,1623,2729,1106,1666,1915,0.149459784
84006075020700,1988,2656,668,1445,2093,0.448442907
84006075020800,2393,2846,453,1093,1246,0.139981702
84006075020900,1628,1894,266,1026,1358,0.323586745
84006075021000,1685,2165,480,1501,1572,0.047301799
84006075021100,1060,1919,859,1803,2262,0.254575707
84006075021200,567,1421,854,1794,2103,0.172240803
84006075021300,511,1227,716,1722,1882,0.092915215
84006075021400,789,1666,877,1695,2669,0.574631268
84006075021500,1458,2580,1122,1640,1784,0.087804878
84006075021600,811,2171,1360,1637,2522,0.540623091
84006075021700,605,1839,1234,1304,1359,0.042177914
84006075021800,730,1867,1137,1983,1879,-0.052445789
84006075022600,474,949,475,2001,3095,0.546726637
84006075022702,669,1003,334,1924,2223,0.155405405
84006075022704,700,1636,936,2001,2289,0.143928036
84006075022801,1158,1947,789,1453,1765,0.214728149
84006075022802,527,672,145,1236,1300,0.051779935
84006075022803,981,1570,589,1497,1616,0.079492318
84006075022901,1238,1540,302,1342,1641,0.222801788
84006075022902,516,832,316,1457,1938,0.330130405
84006075022903,670,1157,487,1567,1651,0.053605616
84006075023001,343,1333,990,980,1198,0.22244898
84006075023003,227,1190,963,1102,2076,0.88384755
84006075023102,1024,1567,543,570,693,0.215789474
84006075023103,924,1045,121,429,606,0.412587413
84006075023200,547,1253,706,1189,1176,-0.010933558
84006075023300,383,949,566,1615,819,-0.492879257
84006075023400,439,861,422,693,519,-0.251082251
84006075025100,396,1400,1004,2001,1706,-0.147426287
84006075025200,893,2117,1224,1476,1809,0.225609756
84006075025300,1012,1734,722,1365,1604,0.175091575
84006075025401,740,1307,567,1461,1604,0.097878166
84006075025402,279,1117,838,1403,2356,0.679258731
84006075025403,622,1447,825,1044,1323,0.267241379
84006075025500,795,2741,1946,1349,1928,0.42920682
84006075025600,481,1598,1117,2001,1152,-0.424287856
84006075025701,404,1475,1071,1488,2002,0.345430108
84006075025702,613,1217,604,1345,1647,0.224535316
84006075025800,242,619,377,1049,1358,0.294566254
84006075025900,448,1504,1056,1789,1903,0.06372275
84006075026001,761,1566,805,1353,1432,0.058388766
84006075026002,231,984,753,1639,1863,0.1366687
84006075026003,529,1395,866,1413,1784,0.262561925
84006075026004,522,1276,754,1233,1782,0.445255474
84006075026100,845,1993,1148,1229,1559,0.268510985
84006075026200,654,2003,1349,1228,1395,0.135993485
84006075026301,584,1406,822,1412,1520,0.076487252
84006075026302,602,1533,931,1424,1445,0.014747191
84006075026303,462,1216,754,1309,1816,0.387318564
84006075026401,298,1061,763,1034,1272,0.230174081
84006075026402,423,1194,771,1500,1803,0.202
84006075026403,511,1051,540,1366,1338,-0.020497804
84006075026404,365,700,335,788,1247,0.58248731
84006075030101,1474,2114,640,1723,1824,0.058618688
84006075030102,1148,2242,1094,1595,1957,0.226959248
84006075030201,1450,1907,457,1475,1741,0.180338983
84006075030202,1563,2149,586,1528,1862,0.218586387
84006075030301,1065,2361,1296,1591,1925,0.209930861
84006075030302,285,1464,1179,2001,1536,-0.232383808
84006075030400,412,1967,1555,1378,1580,0.14658926
84006075030500,288,1040,752,2001,-666666666,-333167.7496
84006075030600,125,878,753,2001,3501,0.749625187
84006075030700,475,2652,2177,1846,2853,0.545503792
84006075030800,530,2260,1730,1805,1621,-0.101939058
84006075030900,223,2343,2120,2001,2506,0.252373813
84006075031000,277,1302,1025,1145,2552,1.228820961
84006075031100,840,2488,1648,1895,1991,0.050659631
84006075031201,847,1983,1136,1092,1611,0.475274725
84006075031202,277,862,585,1652,1719,0.040556901
84006075031301,288,1314,1026,1796,1577,-0.121937639
84006075031302,663,1942,1279,1186,2011,0.695615514
84006075031400,689,1861,1172,1110,1309,0.179279279
84006075032601,1066,1828,762,1402,1772,0.263908702
84006075032602,910,1718,808,1417,1745,0.231474947
84006075032700,792,2461,1669,1469,1880,0.279782165
84006075032801,672,1460,788,1664,1917,0.152043269
84006075032802,558,1544,986,1577,2161,0.370323399
84006075032901,560,1819,1259,1799,2091,0.162312396
84006075032902,424,1385,961,2001,1858,-0.071464268
84006075033000,1115,2710,1595,1808,2100,0.161504425
84006075033100,152,1463,1311,2001,3071,0.534732634
84006075033201,640,640,0,1607,1764,0.097697573
84006075033203,1586,1586,0,1820,2142,0.176923077
84006075033204,1591,1591,0,1702,1851,0.087544066
84006075035100,1116,2849,1733,1700,1870,0.1
84006075035201,689,1960,1271,1492,1795,0.20308311
84006075035202,1183,1834,651,1396,1658,0.187679083
84006075035300,793,2594,1801,1578,1700,0.077313054
84006075035400,1122,2514,1392,1346,1442,0.071322437
84006075040100,1410,1946,536,1253,1659,0.324022346
84006075040200,1672,2433,761,1491,1554,0.042253521
84006075042601,1368,1788,420,1404,1692,0.205128205
84006075042602,979,1383,404,1562,1880,0.203585147
84006075042700,1680,2338,658,1400,1486,0.061428571
84006075042800,219,897,678,2001,2170,0.084457771
84006075045100,1359,2109,750,1565,1659,0.060063898
84006075045200,2026,3020,994,1287,1713,0.331002331
84006075047600,1394,2211,817,1651,1875,0.135675348
84006075047701,1198,1907,709,1212,1551,0.27970297
84006075047702,894,1564,670,1462,1666,0.139534884
84006075047801,839,1590,751,1666,1743,0.046218487
84006075047802,923,1477,554,1433,1661,0.159106769
84006075047901,1150,2679,1529,1336,1380,0.032934132
84006075047902,797,1512,715,1516,1773,0.169525066
84006075060100,1271,1306,35,2001,3001,0.499750125
84006075060400,851,998,147,1458,1645,0.128257888
84006075060502,735,951,216,379,440,0.160949868
84006075060700,3452,5186,1734,2001,2842,0.420289855
84006075061000,621,1594,973,1802,2728,0.513873474
84006075061100,2017,2104,87,490,510,0.040816327
84006075061200,711,1184,473,1075,1293,0.202790698
84006075061400,1294,2483,1189,1572,1537,-0.022264631
84006075061500,4469,7352,2883,2001,2722,0.36031984
84006075980200,41,72,31,1861,2250,0.209027405
84006075980300,76,76,0,896,1619,0.806919643
84006075980401,0,0,0,-666666666,-666666666,0
84006075980501,222,285,63,494,276,-0.441295547
84006075980600,53,188,135,2001,1013,-0.493753123
84006075980900,132,142,10,2001,2000,-0.00049975
84006075990100,0,0,0,-666666666,-666666666,0
84006081600100,631,2092,1461,1415,1718,0.214134276
84006081600200,516,1155,639,1228,1519,0.236970684
84006081600300,234,1219,985,1762,2131,0.209421112
84006081600401,183,1075,892,1622,2242,0.382244143
84006081600402,326,1260,934,1078,1733,0.607606679
84006081600500,621,2040,1419,1572,1873,0.191475827
84006081600600,674,1535,861,1240,1631,0.315322581
84006081600700,1088,2145,1057,1344,1426,0.061011905
84006081600800,2583,2720,137,1415,1795,0.268551237
84006081600900,404,1387,983,2001,2127,0.062968516
84006081601000,266,1984,1718,2001,2053,0.025987006
84006081601100,530,1902,1372,1992,2292,0.15060241
84006081601200,989,2140,1151,1549,1495,-0.034861201
84006081601300,1903,2552,649,1302,1411,0.083717358
84006081601400,840,2142,1302,1695,2096,0.236578171
84006081601501,433,1354,921,1804,2244,0.243902439
84006081601502,1531,1758,227,1341,1727,0.287844892
84006081601601,275,874,599,1495,1353,-0.094983278
84006081601603,655,1890,1235,1902,2236,0.175604627
84006081601604,374,1106,732,1424,1892,0.328651685
84006081601605,532,1758,1226,2001,2495,0.246876562
84006081601700,265,1323,1058,2001,2250,0.124437781
84006081601800,304,2094,1790,1834,1452,-0.208287895
84006081601901,547,1392,845,1484,1641,0.105795148
84006081601902,1329,2172,843,1494,1707,0.142570281
84006081602000,599,2442,1843,1504,1911,0.270611702
84006081602100,713,956,243,1314,1533,0.166666667
84006081602200,2117,2420,303,1320,1422,0.077272727
84006081602300,357,1118,761,1167,1240,0.062553556
84006081602400,1070,2676,1606,1180,1389,0.177118644
84006081602500,224,1515,1291,2001,3387,0.692653673
84006081602600,746,2702,1956,1799,2090,0.161756531
84006081602700,788,1944,1156,1671,1882,0.126271694
84006081602800,382,1499,1117,1966,2336,0.18819939
84006081602900,707,1574,867,1694,2208,0.303423849
84006081603000,932,1828,896,1473,1604,0.088934148
84006081603100,250,1227,977,1560,2070,0.326923077
84006081603200,304,1357,1053,1663,1984,0.193024654
84006081603300,540,2358,1818,1446,2389,0.652143845
84006081603400,533,2111,1578,1564,1573,0.005754476
84006081603700,352,1729,1377,2001,2533,0.265867066
84006081603801,407,1179,772,1295,1598,0.233976834
84006081603802,633,1872,1239,1600,1898,0.18625
84006081603900,978,2089,1111,1662,2094,0.259927798
84006081604000,224,1110,886,2001,2483,0.24087956
84006081604101,1878,2507,629,1449,1566,0.080745342
84006081604102,1038,1579,541,1324,1878,0.418429003
84006081604200,482,1110,628,1479,1627,0.100067613
84006081604400,1085,1750,665,1346,1603,0.190936107
84006081604500,369,1299,930,1780,2565,0.441011236
84006081604600,119,954,835,2001,3139,0.568715642
84006081604700,197,954,757,2001,2563,0.28085957
84006081604800,1085,1884,799,1627,1981,0.217578365
84006081604900,225,1217,992,2001,2074,0.036481759
84006081605000,1157,2895,1738,1612,1583,-0.017990074
84006081605100,860,1420,560,1353,1635,0.208425721
84006081605200,249,1262,1013,1940,2013,0.037628866
84006081605300,833,1845,1012,1510,1894,0.254304636
84006081605400,1337,2441,1104,1430,1867,0.305594406
84006081605500,2099,2751,652,1335,1785,0.337078652
84006081605600,145,1934,1789,2001,2438,0.218390805
84006081605700,150,1771,1621,2001,2531,0.264867566
84006081605800,183,972,789,1572,1897,0.206743003
84006081605900,1710,2585,875,1356,1481,0.092182891
84006081606000,1260,2124,864,1441,1673,0.160999306
84006081606100,488,1310,822,1382,1556,0.125904486
84006081606200,1591,2256,665,1603,1668,0.040548971
84006081606300,1004,1831,827,1457,1670,0.146190803
84006081606400,1591,2530,939,1441,1934,0.342123525
84006081606500,76,1251,1175,1453,1828,0.258086717
84006081606600,602,1452,850,1293,1868,0.444702243
84006081606700,142,955,813,1950,2013,0.032307692
84006081606800,286,1269,983,1478,2034,0.376184032
84006081606900,167,917,750,2001,1947,-0.026986507
84006081607000,530,1384,854,1470,1886,0.282993197
84006081607100,77,1079,1002,2001,3177,0.587706147
84006081607200,1262,1718,456,1663,1881,0.131088394
84006081607300,189,1327,1138,2001,2145,0.071964018
84006081607400,1022,1886,864,1438,1689,0.174547983
84006081607500,988,1606,618,2001,2138,0.068465767
84006081607600,415,1259,844,1378,1630,0.18287373
84006081607701,471,1185,714,1859,1999,0.075309306
84006081607702,204,798,594,2001,2211,0.104947526
84006081607800,153,990,837,1469,2733,0.860449285
84006081607900,750,1658,908,1820,2426,0.332967033
84006081608001,837,1606,769,1863,2361,0.267310789
84006081608002,266,1364,1098,2001,3419,0.708645677
84006081608004,1797,3141,1344,1880,2539,0.350531915
84006081608013,744,1685,941,2001,3076,0.537231384
84006081608023,125,908,783,2001,3501,0.749625187
84006081608100,585,1437,852,1791,2111,0.178671133
84006081608200,407,1349,942,2001,2605,0.301849075
84006081608300,699,1416,717,1749,2255,0.289308176
84006081608400,1481,2175,694,1682,2493,0.48216409
84006081608501,481,1658,1177,1626,1900,0.168511685
84006081608502,558,1180,622,1581,1974,0.24857685
84006081608600,990,1705,715,1420,1948,0.371830986
84006081608700,796,2607,1811,1253,1763,0.407023144
84006081608800,207,2100,1893,2001,2129,0.063968016
84006081608900,1846,2944,1098,1491,1669,0.119382964
84006081609000,251,953,702,1462,1576,0.077975376
84006081609100,141,568,427,1246,1953,0.56741573
84006081609201,673,1588,915,1522,1743,0.145203679
84006081609202,1411,1945,534,1389,1713,0.233261339
84006081609300,212,1248,1036,1500,1660,0.106666667
84006081609400,107,1113,1006,2001,3042,0.52023988
84006081609500,244,1742,1498,1772,2091,0.180022573
84006081609601,373,1168,795,1809,2177,0.203427308
84006081609602,45,678,633,1972,2563,0.29969574
84006081609603,183,1981,1798,1986,1953,-0.016616314
84006081609700,166,1678,1512,2001,3143,0.570714643
84006081609800,406,1694,1288,1612,1856,0.151364764
84006081609900,144,1082,938,2001,2482,0.24037981
84006081610000,1176,2073,897,1141,1787,0.566170026
84006081610100,463,925,462,1173,1628,0.387894288
84006081610201,1316,1770,454,1168,1452,0.243150685
84006081610202,792,828,36,1066,1498,0.405253283
84006081610203,945,1040,95,1211,1577,0.302229562
84006081610302,389,923,534,1063,1352,0.27187206
84006081610303,1178,3253,2075,2001,2828,0.413293353
84006081610304,350,1898,1548,1826,2257,0.236035049
84006081610400,1095,1698,603,1408,1773,0.259232955
84006081610500,612,1378,766,990,1569,0.584848485
84006081610601,1177,1677,500,1169,1492,0.276304534
84006081610602,261,1215,954,1769,-666666666,-376861.7496
84006081610700,1252,2163,911,1551,1957,0.261766602
84006081610800,1524,1688,164,1249,1720,0.377101681
84006081610900,1839,2543,704,1416,1636,0.155367232
84006081611000,1115,2320,1205,1704,1890,0.10915493
84006081611100,261,2325,2064,1974,1953,-0.010638298
84006081611200,180,1061,881,2001,2572,0.285357321
84006081611300,686,2019,1333,1588,2438,0.535264484
84006081611400,119,1411,1292,2001,3202,0.6001999
84006081611500,47,920,873,2001,2375,0.186906547
84006081611600,141,793,652,2001,2291,0.144927536
84006081611700,752,1371,619,1169,1445,0.23609923
84006081611800,318,832,514,1669,1786,0.070101857
84006081611900,1482,2637,1155,1641,1782,0.085923218
84006081612000,905,1542,637,1434,1704,0.188284519
84006081612100,2312,2744,432,1096,1392,0.270072993
84006081612500,1076,1870,794,1729,1829,0.0578369
84006081612600,1379,2018,639,1747,2105,0.204922725
84006081612700,65,733,668,2001,1964,-0.018490755
84006081612800,110,985,875,2001,2571,0.284857571
84006081612900,385,1717,1332,2001,2572,0.285357321
84006081613000,470,1419,949,2001,2635,0.316841579
84006081613200,348,2622,2274,2001,3038,0.51824088
84006081613300,58,946,888,1205,1750,0.452282158
84006081613400,197,1159,962,2001,1835,-0.082958521
84006081613501,555,1638,1083,1635,2207,0.349847095
84006081613502,457,2335,1878,1629,1945,0.193984039
84006081613600,457,2297,1840,2001,1568,-0.216391804
84006081613700,1130,3706,2576,1247,1243,-0.003207698
84006081613800,497,1381,884,989,1375,0.390293225
84006081613900,737,2069,1332,1515,1668,0.100990099
84006081614000,525,1665,1140,2001,2563,0.28085957
84006081984300,0,0,0,-666666666,-666666666,0
84006081990100,0,0,0,-666666666,-666666666,0
84006085500100,1474,2395,921,1382,1478,0.069464544
84006085500200,1560,2145,585,1499,1662,0.108739159
84006085500300,741,1464,723,1573,2175,0.382708201
84006085500400,663,997,334,1125,1434,0.274666667
84006085500500,602,2051,1449,1080,1456,0.348148148
84006085500600,1522,2364,842,1265,1431,0.131225296
84006085500800,1145,1764,619,849,1620,0.908127208
84006085500901,1723,2063,340,1202,1487,0.237104825
84006085500902,594,610,16,988,1225,0.239878543
84006085501000,1671,1997,326,1019,1133,0.111874387
84006085501101,1601,1944,343,1214,1468,0.2092257
84006085501102,445,1379,934,1334,1679,0.25862069
84006085501200,968,1373,405,1251,1381,0.103916867
84006085501300,625,1138,513,1144,1421,0.242132867
84006085501401,719,1037,318,1075,1296,0.205581395
84006085501402,618,917,299,1137,1325,0.165347405
84006085501501,754,1322,568,1184,1350,0.140202703
84006085501502,573,1181,608,1082,1383,0.27818854
84006085501600,2037,2495,458,998,1365,0.367735471
84006085501700,1084,1344,260,1183,1481,0.251901944
84006085501800,599,1737,1138,1380,1564,0.133333333
84006085501900,1875,2637,762,1144,1749,0.528846154
84006085502001,1310,2113,803,1027,1301,0.266796495
84006085502002,1281,1653,372,1118,1399,0.251341682
84006085502101,676,1935,1259,1561,1716,0.099295324
84006085502102,2156,2693,537,1203,1528,0.270157938
84006085502201,2467,3032,565,1334,1618,0.212893553
84006085502202,676,1446,770,1574,1694,0.076238882
84006085502301,630,1354,724,1459,1832,0.255654558
84006085502302,854,1275,421,1219,1589,0.303527482
84006085502400,580,2775,2195,1745,1684,-0.03495702
84006085502500,397,2461,2064,2001,1888,-0.056471764
84006085502601,340,1207,867,1750,1902,0.086857143
84006085502603,336,976,640,1440,2097,0.45625
84006085502604,1387,1990,603,1429,1842,0.289013296
84006085502701,862,1972,1110,1309,1681,0.284186402
84006085502702,928,2984,2056,1459,1899,0.301576422
84006085502800,310,1444,1134,1970,2188,0.110659898
84006085502901,954,2231,1277,1316,1452,0.103343465
84006085502902,350,2707,2357,1783,2064,0.157599551
84006085502903,309,1924,1615,1884,2672,0.418259023
84006085502906,476,1539,1063,1639,1693,0.032946919
84006085502907,179,1314,1135,2001,2597,0.297851074
84006085502908,634,2422,1788,1128,1590,0.409574468
84006085502909,1024,2077,1053,1399,1718,0.228020014
84006085502910,744,1373,629,1261,1634,0.295796987
84006085503001,273,1634,1361,2001,2599,0.298850575
84006085503002,344,1200,856,1915,1912,-0.00156658
84006085503003,254,1836,1582,2001,2281,0.139930035
84006085503105,512,765,253,904,822,-0.090707965
84006085503108,1548,2781,1233,1404,1441,0.026353276
84006085503110,878,1151,273,1158,1395,0.204663212
84006085503111,331,1127,796,1411,1710,0.211906449
84006085503112,960,1462,502,1178,1354,0.149405772
84006085503113,884,1369,485,1208,1357,0.123344371
84006085503115,392,2696,2304,1424,1761,0.236657303
84006085503116,1014,2276,1262,1714,2144,0.250875146
84006085503117,521,768,247,1312,1360,0.036585366
84006085503118,1213,1670,457,1359,1685,0.239882266
84006085503121,1029,1501,472,1042,1388,0.332053743
84006085503122,758,1154,396,594,598,0.006734007
84006085503123,1193,1644,451,1263,1413,0.118764846
84006085503204,999,2279,1280,1221,1353,0.108108108
84006085503207,265,1059,794,1672,2039,0.219497608
84006085503208,241,897,656,2001,2076,0.037481259
84006085503210,313,968,655,1909,1796,-0.059193295
84006085503211,228,1153,925,1883,2077,0.103027084
84006085503212,222,957,735,2001,2389,0.193903048
84006085503213,486,1264,778,1428,1616,0.131652661
84006085503214,1146,2330,1184,1136,1141,0.004401408
84006085503217,486,1093,607,1590,1708,0.074213836
84006085503218,815,1181,366,1055,1150,0.090047393
84006085503304,910,1908,998,1326,1414,0.066365008
84006085503305,576,1500,924,1230,2018,0.640650407
84006085503306,256,906,650,2001,1750,-0.125437281
84006085503312,215,1079,864,1934,1680,-0.131334023
84006085503313,103,1297,1194,2001,2722,0.36031984
84006085503315,774,2040,1266,1741,1921,0.103388857
84006085503321,201,1090,889,1920,2313,0.2046875
84006085503322,190,1067,877,1705,2586,0.516715543
84006085503323,237,1183,946,1676,2483,0.48150358
84006085503324,148,908,760,2001,2553,0.275862069
84006085503325,254,1157,903,1901,2074,0.091004734
84006085503326,354,1813,1459,2001,1568,-0.216391804
84006085503327,517,1433,916,1913,2323,0.214323053
84006085503329,104,980,876,2001,2750,0.374312844
84006085503330,275,2158,1883,1307,2852,1.182096404
84006085503331,240,1360,1120,1180,1636,0.386440678
84006085503332,184,2579,2395,2001,2389,0.193903048
84006085503333,280,1296,1016,1962,2342,0.193679918
84006085503334,140,2525,2385,2001,2623,0.310844578
84006085503336,259,895,636,2001,1681,-0.15992004
84006085503337,212,961,749,2001,2018,0.008495752
84006085503401,335,948,613,1846,2099,0.137053088
84006085503402,843,1255,412,1083,1352,0.248384118
84006085503504,475,1218,743,1868,2010,0.076017131
84006085503506,560,1290,730,1381,1745,0.263577118
84006085503507,112,389,277,1737,2057,0.184225676
84006085503508,466,1267,801,1270,2106,0.658267717
84006085503509,198,901,703,2001,1990,-0.005497251
84006085503510,669,1407,738,1558,1569,0.007060334
84006085503511,249,865,616,1905,2243,0.177427822
84006085503601,541,881,340,1079,1324,0.227062095
84006085503602,697,1352,655,1262,1110,-0.12044374
84006085503703,444,953,509,1170,1297,0.108547009
84006085503707,710,1431,721,1436,1820,0.267409471
84006085503708,296,762,466,755,-666666666,-883003.2066
84006085503709,1371,1698,327,678,816,0.203539823
84006085503710,828,1044,216,1034,897,-0.132495164
84006085503711,632,1038,406,1436,1529,0.064763231
84006085503712,1035,1369,334,964,1137,0.179460581
84006085503713,965,1172,207,968,1242,0.283057851
84006085503802,777,2252,1475,1418,1699,0.198166432
84006085503803,338,1417,1079,1797,1664,-0.074012243
84006085503804,601,1664,1063,1389,1864,0.341972642
84006085503902,794,1533,739,1352,1626,0.202662722
84006085503903,465,936,471,1198,1565,0.306343907
84006085504001,724,1567,843,1339,1460,0.090365945
84006085504002,833,1430,597,1379,1449,0.050761421
84006085504101,378,1095,717,1412,1593,0.128186969
84006085504102,460,1352,892,1397,1781,0.274874732
84006085504201,404,1806,1402,1777,1792,0.008441193
84006085504202,289,1473,1184,2001,2010,0.004497751
84006085504307,525,1716,1191,1521,1747,0.148586456
84006085504308,272,1525,1253,1591,1128,-0.291011942
84006085504311,783,2411,1628,1751,2153,0.229583095
84006085504314,362,1333,971,1678,2283,0.360548272
84006085504315,478,2000,1522,1627,1960,0.204671174
84006085504316,370,1409,1039,2001,2087,0.042978511
84006085504317,235,1198,963,1497,2526,0.687374749
84006085504318,232,1505,1273,1131,1324,0.170645447
84006085504319,628,2061,1433,1540,2049,0.330519481
84006085504320,89,844,755,2001,2572,0.285357321
84006085504321,480,1589,1109,1440,2016,0.4
84006085504322,1295,2043,748,1687,1900,0.126259632
84006085504323,862,1893,1031,1651,2189,0.325863113
84006085504410,412,1192,780,1199,1557,0.298582152
84006085504411,221,1561,1340,1904,2404,0.262605042
84006085504412,693,1342,649,1450,1715,0.182758621
84006085504413,286,721,435,923,985,0.067172264
84006085504414,177,1552,1375,2001,2651,0.324837581
84006085504415,217,1593,1376,2001,2226,0.112443778
84006085504416,358,1116,758,1718,2285,0.330034924
84006085504417,33,129,96,2001,-666666666,-333167.7496
84006085504418,647,1352,705,1492,1706,0.143431635
84006085504420,429,1416,987,1354,2066,0.525849335
84006085504421,261,1384,1123,1885,2486,0.318832891
84006085504422,338,1061,723,1487,1158,-0.221250841
84006085504423,123,691,568,2001,2142,0.070464768
84006085504504,1576,2899,1323,1580,1909,0.208227848
84006085504505,664,2020,1356,1872,2277,0.216346154
84006085504506,1206,2244,1038,1605,2141,0.333956386
84006085504507,595,1831,1236,1474,1700,0.153324288
84006085504601,72,353,281,1212,1207,-0.004125413
84006085504602,263,635,372,1316,1546,0.174772036
84006085504700,200,200,0,1921,3105,0.616345653
84006085504802,546,1797,1251,1539,2004,0.30214425
84006085504803,1401,2491,1090,1614,2325,0.440520446
84006085504805,687,2694,2007,1837,2430,0.322808928
84006085504806,174,775,601,2001,2535,0.266866567
84006085504901,2719,4123,1404,1811,2461,0.358917725
84006085505001,1999,3450,1451,1858,2157,0.160925727
84006085505006,2585,3251,666,1892,2612,0.380549683
84006085505007,377,952,575,1466,2073,0.414051842
84006085505008,2462,2462,0,1993,2467,0.237832413
84006085505009,1929,3352,1423,1589,2304,0.449968534
84006085505100,1091,1670,579,1241,1348,0.08622079
84006085505202,1765,2374,609,1252,1429,0.141373802
84006085505203,865,1447,582,1826,2395,0.311610077
84006085505301,731,1412,681,1311,1660,0.266209001
84006085505302,463,1387,924,1421,1805,0.270232231
84006085505303,1365,2163,798,1262,1670,0.323296355
84006085505304,155,1099,944,2001,2623,0.310844578
84006085505305,869,2076,1207,1304,1772,0.358895706
84006085505401,1905,2581,676,1647,2106,0.278688525
84006085505402,460,1137,677,1415,1750,0.236749117
84006085505403,1723,2567,844,1633,1960,0.200244948
84006085505500,751,1578,827,1250,1497,0.1976
84006085505600,997,1235,238,1320,1417,0.073484848
84006085505700,1927,2461,534,1206,1794,0.487562189
84006085505800,683,1550,867,1497,1953,0.304609218
84006085505900,1840,3116,1276,1216,1707,0.403782895
84006085506000,895,1814,919,1668,2086,0.25059952
84006085506101,604,1730,1126,1480,1878,0.268918919
84006085506102,498,1493,995,1711,2248,0.313851549
84006085506103,620,1645,1025,1674,1964,0.173237754
84006085506202,994,2515,1521,1497,1783,0.191048764
84006085506203,1766,2379,613,1467,1779,0.212678937
84006085506204,669,2086,1417,1483,1648,0.111260958
84006085506301,1603,2290,687,1322,1739,0.315431165
84006085506302,1132,2504,1372,1378,1842,0.336719884
84006085506304,1692,2088,396,1361,1774,0.303453343
84006085506305,2163,2569,406,1185,1482,0.250632911
84006085506401,1343,2103,760,1386,1830,0.32034632
84006085506402,1540,2253,713,1239,1610,0.299435028
84006085506501,1679,2487,808,1196,1514,0.265886288
84006085506502,1061,1878,817,1598,2131,0.333541927
84006085506503,1648,2609,961,1330,1646,0.237593985
84006085506601,851,1693,842,1223,1526,0.247751431
84006085506603,312,1340,1028,2001,2013,0.005997001
84006085506604,580,2562,1982,1736,1762,0.014976959
84006085506605,903,1508,605,1242,1505,0.211755233
84006085506606,844,1596,752,1350,1570,0.162962963
84006085506701,334,1253,919,2001,2126,0.062468766
84006085506702,913,1935,1022,1317,1770,0.343963554
84006085506703,592,1308,716,1675,1906,0.137910448
84006085506801,687,2172,1485,1869,2002,0.071161049
84006085506802,460,1935,1475,1422,1987,0.397327707
84006085506803,718,2363,1645,1215,1492,0.227983539
84006085506804,183,1278,1095,2001,2461,0.229885057
84006085506900,433,2634,2201,2001,2132,0.065467266
84006085507001,925,2977,2052,1915,1893,-0.011488251
84006085507002,180,1005,825,1909,2070,0.084337349
84006085507100,855,1282,427,1429,1675,0.172148355
84006085507203,584,1166,582,1963,2378,0.211411105
84006085507205,200,1825,1625,1859,1951,0.049488973
84006085507206,92,1055,963,2001,2193,0.095952024
84006085507301,508,2414,1906,963,-666666666,-692282.0654
84006085507302,247,1031,784,984,3098,2.148373984
84006085507401,194,1860,1666,2001,3501,0.749625187
84006085507402,286,1453,1167,1750,3000,0.714285714
84006085507500,189,2028,1839,2001,3089,0.543728136
84006085507600,240,1962,1722,1962,2310,0.177370031
84006085507701,292,1372,1080,2001,2250,0.124437781
84006085507702,258,2058,1800,2001,3501,0.749625187
84006085507703,990,2693,1703,1974,2332,0.181357649
84006085507805,1323,2203,880,1679,2352,0.40083383
84006085507806,1191,1811,620,1815,2599,0.431955923
84006085507807,334,1052,718,1871,2383,0.273650454
84006085507808,421,1773,1352,1978,2898,0.465116279
84006085507903,283,1626,1343,2001,2412,0.205397301
84006085507904,119,1098,979,2001,3079,0.538730635
84006085507905,1139,2152,1013,1511,1814,0.200529451
84006085507906,203,1411,1208,2001,3058,0.528235882
84006085508001,1124,2858,1734,2001,2727,0.362818591
84006085508003,375,770,395,1891,2347,0.241142253
84006085508004,1072,2210,1138,1792,2163,0.20703125
84006085508101,846,2327,1481,2001,2731,0.364817591
84006085508102,647,1193,546,1851,2290,0.237169098
84006085508202,1152,2772,1620,1476,2194,0.486449864
84006085508203,545,1797,1252,1467,1964,0.338786639
84006085508204,397,1481,1084,1424,2252,0.581460674
84006085508301,322,1567,1245,1772,2824,0.593679458
84006085508303,103,924,821,2001,2558,0.27836082
84006085508304,2204,3058,854,1408,1638,0.163352273
84006085508401,803,2350,1547,1659,2255,0.359252562
84006085508403,158,1078,920,2001,2750,0.374312844
84006085508404,984,2328,1344,1795,1859,0.035654596
84006085508503,1853,2630,777,1410,1852,0.313475177
84006085508504,2931,3396,465,1481,1855,0.252532073
84006085508505,901,1914,1013,1626,2146,0.319803198
84006085508507,992,1343,351,1452,2061,0.419421488
84006085508508,1176,2029,853,1486,1810,0.218034993
84006085508601,521,1355,834,1515,1721,0.135973597
84006085508602,1532,2016,484,1422,1983,0.394514768
84006085508703,2018,3256,1238,1562,2013,0.288732394
84006085508704,1748,2603,855,1676,2119,0.264319809
84006085508800,1082,1460,378,1402,1895,0.351640514
84006085508900,1002,1700,698,1335,1696,0.270411985
84006085509000,1452,2540,1088,1160,1660,0.431034483
84006085509102,1514,2274,760,1702,2258,0.326674501
84006085509105,2017,3057,1040,1740,2099,0.206321839
84006085509106,1149,1693,544,1380,1722,0.247826087
84006085509107,1927,1946,19,1322,1937,0.465204236
84006085509108,1404,1967,563,1366,1715,0.255490483
84006085509109,875,1943,1068,1943,2401,0.235717962
84006085509201,1282,2337,1055,1593,2127,0.335216573
84006085509202,1030,1885,855,1376,1836,0.334302326
84006085509302,398,1222,824,1280,1874,0.4640625
84006085509303,1257,1743,486,1160,1488,0.282758621
84006085509304,779,1357,578,1557,2014,0.293513166
84006085509401,1417,1757,340,1337,1782,0.332834705
84006085509403,1938,2052,114,1369,1843,0.34623813
84006085509404,1705,2683,978,1490,1959,0.314765101
84006085509500,1837,2240,403,1459,1779,0.219328307
84006085509600,1008,1483,475,1780,2337,0.312921348
84006085509700,868,1408,540,1552,2173,0.400128866
84006085509801,767,2172,1405,1247,1490,0.194867682
84006085509802,382,1131,749,1131,1684,0.488947834
84006085509901,128,689,561,2001,2723,0.36081959
84006085509902,605,1839,1234,1327,1716,0.293142427
84006085510001,166,2063,1897,2001,2983,0.490754623
84006085510002,235,1291,1056,1908,3092,0.620545073
84006085510100,91,1081,990,2001,3501,0.749625187
84006085510200,143,1440,1297,2001,2725,0.36181909
84006085510300,401,1716,1315,2001,2487,0.242878561
84006085510400,165,1165,1000,2001,2306,0.152423788
84006085510500,363,1891,1528,2001,2579,0.288855572
84006085510600,847,2350,1503,1629,2190,0.344383057
84006085510700,1107,2046,939,1644,1889,0.149026764
84006085510801,599,2210,1611,2001,2016,0.007496252
84006085510802,125,683,558,1750,1872,0.069714286
84006085510803,404,997,593,1469,1741,0.185159973
84006085510900,742,2040,1298,1728,2325,0.345486111
84006085511000,934,2449,1515,1758,2562,0.457337884
84006085511100,314,1846,1532,2001,2945,0.471764118
84006085511200,420,1670,1250,2001,3207,0.602698651
84006085511301,1107,1801,694,1628,2319,0.424447174
84006085511302,1625,2136,511,1622,1706,0.051787916
84006085511400,456,1335,879,2001,2323,0.16091954
84006085511500,1375,3043,1668,1705,2377,0.394134897
84006085511608,89,93,4,-666666666,1556,-1.000002334
84006085511609,1503,1714,211,2001,2807,0.402798601
84006085511701,222,1565,1343,2001,2351,0.174912544
84006085511702,47,945,898,2001,2750,0.374312844
84006085511704,102,1723,1621,2001,1681,-0.15992004
84006085511705,51,357,306,2001,1607,-0.196901549
84006085511707,136,1206,1070,1144,2865,1.504370629
84006085511800,382,1645,1263,2001,1567,-0.216891554
84006085511905,221,1063,842,1726,2083,0.206836616
84006085511907,252,1344,1092,2001,3000,0.499250375
84006085511909,141,2658,2517,2001,3239,0.618690655
84006085511910,67,1051,984,2001,3429,0.713643178
84006085511911,518,1879,1361,1375,1216,-0.115636364
84006085511912,233,1748,1515,2001,2569,0.283858071
84006085511913,71,1427,1356,2001,3501,0.749625187
84006085511914,182,1918,1736,1979,2557,0.2920667
84006085511915,859,1275,416,1167,1338,0.146529563
84006085511916,507,1696,1189,1178,1319,0.119694397
84006085512001,327,2012,1685,2001,2613,0.305847076
84006085512005,544,2217,1673,1919,2366,0.23293382
84006085512017,843,2213,1370,1396,1492,0.068767908
84006085512019,572,1563,991,1785,2026,0.135014006
84006085512020,1998,2561,563,1443,1809,0.253638254
84006085512021,365,2047,1682,2001,2337,0.167916042
84006085512022,820,1888,1068,1355,1634,0.205904059
84006085512023,986,2024,1038,1701,1863,0.095238095
84006085512024,704,1635,931,1408,1434,0.018465909
84006085512025,229,1079,850,2001,2394,0.196401799
84006085512026,440,1312,872,1381,1975,0.430123099
84006085512027,958,1577,619,1622,1822,0.123304562
84006085512029,624,2472,1848,1849,2116,0.14440238
84006085512030,157,993,836,2001,2750,0.374312844
84006085512031,277,1369,1092,2001,2582,0.290354823
84006085512032,164,1006,842,2001,2278,0.138430785
84006085512033,640,2033,1393,1724,1938,0.12412993
84006085512034,232,1019,787,2001,2406,0.202398801
84006085512035,329,1412,1083,1655,1716,0.036858006
84006085512036,1312,1888,576,1937,2296,0.185338152
84006085512037,168,975,807,2001,2407,0.202898551
84006085512038,358,1073,715,1706,1939,0.136576788
84006085512039,293,1339,1046,1903,2201,0.15659485
84006085512042,371,868,497,1121,1381,0.231935772
84006085512043,981,1592,611,1178,1364,0.157894737
84006085512045,268,1808,1540,2001,2342,0.170414793
84006085512047,375,1708,1333,1714,2007,0.170945158
84006085512052,998,1762,764,1749,2036,0.164093768
84006085512053,493,1433,940,1658,1578,-0.048250905
84006085512100,170,455,285,1856,1714,-0.076508621
84006085512200,241,1657,1416,1592,1490,-0.064070352
84006085512305,279,1480,1201,1563,1827,0.16890595
84006085512307,453,2359,1906,1849,2028,0.096809086
84006085512308,393,2464,2071,1784,2515,0.409753363
84006085512309,309,1712,1403,1453,2122,0.460426703
84006085512310,880,1447,567,1270,1470,0.157480315
84006085512311,249,1189,940,650,1214,0.867692308
84006085512312,204,1079,875,1392,2211,0.588362069
84006085512313,739,1186,447,1529,1587,0.03793329
84006085512314,917,2158,1241,1420,1398,-0.015492958
84006085512401,393,1420,1027,1256,1662,0.323248408
84006085512402,375,1446,1071,1859,1526,-0.179128564
84006085512503,375,2731,2356,2001,3226,0.612193903
84006085512505,1023,2186,1163,1239,1678,0.354317998
84006085512506,1048,1906,858,1107,1192,0.076784101
84006085512508,1223,2630,1407,1351,1446,0.070318283
84006085512509,239,1227,988,1177,1532,0.301614274
84006085512510,971,2258,1287,1415,1591,0.124381625
84006085512602,320,802,482,1277,1322,0.035238841
84006085512603,868,1101,233,1028,1341,0.304474708
84006085512604,793,1174,381,1242,1466,0.180354267
84006085513000,2213,2223,10,1251,1537,0.228617106
84006085513500,97,306,209,769,1036,0.347204161
84006095250103,622,1547,925,1434,1318,-0.080892608
84006095250104,229,814,585,2001,1934,-0.033483258
84006095250105,819,2207,1388,1315,1479,0.124714829
84006095250106,143,1396,1253,1788,2699,0.50950783
84006095250200,763,1472,709,1186,1353,0.140809444
84006095250300,447,1114,667,1395,1404,0.006451613
84006095250400,401,1034,633,1251,1259,0.006394884
84006095250501,254,776,522,1172,1667,0.422354949
84006095250502,301,1000,699,1333,1790,0.342835709
84006095250601,543,1560,1017,1368,1660,0.213450292
84006095250604,424,1384,960,1483,1564,0.054619016
84006095250605,485,1577,1092,1540,1901,0.234415584
84006095250701,493,1132,639,1143,1121,-0.019247594
84006095250801,689,1436,747,1227,1323,0.078239609
84006095250900,1106,1207,101,548,668,0.218978102
84006095251000,783,1058,275,995,1130,0.135678392
84006095251100,699,1105,406,1097,1220,0.112123974
84006095251200,748,1282,534,993,1108,0.115810675
84006095251300,303,1179,876,1613,1589,-0.014879107
84006095251400,791,2126,1335,1112,1183,0.063848921
84006095251500,1068,1464,396,988,1075,0.08805668
84006095251600,886,1069,183,975,978,0.003076923
84006095251701,855,1368,513,995,1062,0.067336683
84006095251702,421,937,516,1369,1300,-0.050401753
84006095251802,902,1213,311,821,785,-0.043848965
84006095251803,439,1384,945,1573,1671,0.062301335
84006095251804,277,972,695,1731,1775,0.025418833
84006095251901,1099,1829,730,1346,1194,-0.112927192
84006095251902,766,1773,1007,1323,1549,0.170823885
84006095251903,523,1653,1130,1547,1592,0.029088559
84006095252000,1037,2148,1111,1007,1279,0.270109235
84006095252102,587,1473,886,1157,1471,0.27139153
84006095252103,987,1980,993,1257,1248,-0.007159905
84006095252104,261,1812,1551,1183,1413,0.194420964
84006095252105,252,1250,998,1623,1753,0.080098583
84006095252106,636,1717,1081,1405,1500,0.067615658
84006095252107,299,1404,1105,1738,1449,-0.166283084
84006095252108,484,1345,861,1424,1387,-0.025983146
84006095252201,553,3030,2477,2001,2302,0.150424788
84006095252202,552,3191,2639,1790,2124,0.186592179
84006095252305,461,1680,1219,1713,1602,-0.064798599
84006095252306,298,1241,943,1516,1383,-0.087730871
84006095252310,324,1261,937,1787,2399,0.342473419
84006095252311,380,1449,1069,1490,1848,0.240268456
84006095252312,663,1342,679,1537,1475,-0.040338321
84006095252313,923,2193,1270,1227,1227,0
84006095252314,597,1361,764,1600,1535,-0.040625
84006095252315,281,1436,1155,1654,1743,0.053808948
84006095252316,467,1138,671,1791,1662,-0.072026801
84006095252317,607,2153,1546,1976,2019,0.021761134
84006095252401,658,1313,655,1214,1450,0.194398682
84006095252402,1042,1749,707,812,899,0.107142857
84006095252501,656,913,257,1201,1008,-0.160699417
84006095252502,540,654,114,869,1048,0.20598389
84006095252604,681,1038,357,1000,967,-0.033
84006095252605,1298,1895,597,1073,1048,-0.023299161
84006095252606,1075,1632,557,989,942,-0.04752275
84006095252607,745,1150,405,1108,1009,-0.089350181
84006095252608,776,1288,512,1041,1193,0.146013449
84006095252610,381,1028,647,1333,1492,0.11927982
84006095252611,593,1074,481,1180,1176,-0.003389831
84006095252702,962,2239,1277,1264,1492,0.180379747
84006095252703,532,1218,686,1717,1613,-0.060570763
84006095252704,815,1655,840,1119,1185,0.058981233
84006095252705,569,1787,1218,1466,1756,0.19781719
84006095252706,246,1193,947,1693,2199,0.298877732
84006095252707,686,1677,991,1190,1407,0.182352941
84006095252801,827,840,13,1816,1806,-0.005506608
84006095252802,280,280,0,1865,1748,-0.062734584
84006095252903,291,1665,1374,994,1145,0.151911469
84006095252904,741,2254,1513,1476,1647,0.115853659
84006095252908,706,1283,577,1235,1456,0.178947368
84006095252909,216,1050,834,1801,1897,0.05330372
84006095252910,654,2009,1355,1551,1747,0.126370084
84006095252911,1122,2728,1606,1288,1135,-0.11878882
84006095252912,502,1836,1334,2001,2179,0.088955522
84006095252913,515,1628,1113,1712,1820,0.063084112
84006095252914,580,1801,1221,1477,1460,-0.011509817
84006095252915,185,1287,1102,1958,2209,0.128192033
84006095253000,0,0,0,-666666666,-666666666,0
84006095253101,941,2047,1106,1120,1249,0.115178571
84006095253105,1669,2408,739,1296,1318,0.016975309
84006095253106,601,1259,658,1239,1432,0.155770783
84006095253107,1234,2325,1091,1127,1363,0.209405501
84006095253108,657,1612,955,1174,1154,-0.017035775
84006095253201,221,1819,1598,1625,2078,0.278769231
84006095253203,733,1429,696,1196,1377,0.151337793
84006095253204,1185,2351,1166,1065,1019,-0.043192488
84006095253205,434,990,556,1540,1341,-0.129220779
84006095253206,238,1005,767,2001,2201,0.099950025
84006095253300,423,913,490,1151,1104,-0.040834057
84006095253402,841,2204,1363,1029,1149,0.116618076
84006095253403,234,1521,1287,1830,1684,-0.079781421
84006095253404,803,2191,1388,1203,1109,-0.078137988
84006095253500,1216,4405,3189,1092,1282,0.173992674
84006095980000,0,0,0,-666666666,-666666666,0
84006097150100,274,1025,751,1346,1313,-0.024517088
84006097150202,790,2348,1558,1195,1380,0.154811715
84006097150203,989,2273,1284,1417,1615,0.139731828
84006097150204,823,1741,918,1416,1433,0.01200565
84006097150303,371,2292,1921,1398,1620,0.158798283
84006097150304,870,2182,1312,1335,1388,0.039700375
84006097150305,910,1789,879,1208,1213,0.004139073
84006097150306,550,1645,1095,999,1126,0.127127127
84006097150500,746,2185,1439,1188,1319,0.11026936
84006097150601,447,1378,931,1234,1498,0.213938412
84006097150602,161,1460,1299,1759,2106,0.197271177
84006097150603,1026,2561,1535,1354,1171,-0.135155096
84006097150607,382,1770,1388,1421,1845,0.298381422
84006097150609,509,1948,1439,1530,1632,0.066666667
84006097150610,286,1359,1073,1924,1895,-0.015072765
84006097150611,748,1547,799,1235,1695,0.372469636
84006097150612,462,1627,1165,1663,2073,0.246542393
84006097150701,1142,2061,919,1362,1491,0.094713656
84006097150702,417,1819,1402,1844,1817,-0.014642082
84006097150800,972,2008,1036,1389,1416,0.019438445
84006097150901,925,2002,1077,1148,1136,-0.010452962
84006097150902,456,1397,941,1216,1578,0.297697368
84006097151000,619,1512,893,1167,1332,0.141388175
84006097151100,745,1891,1146,1316,1678,0.275075988
84006097151201,1013,2799,1786,1299,1293,-0.004618938
84006097151203,768,1896,1128,1005,1503,0.495522388
84006097151204,563,1326,763,1215,1296,0.066666667
84006097151301,775,1599,824,969,1192,0.230134159
84006097151305,1776,2366,590,1071,1192,0.112978525
84006097151306,678,1550,872,1224,1361,0.111928105
84006097151307,538,1958,1420,1369,1906,0.392257122
84006097151308,922,1914,992,1376,1432,0.040697674
84006097151309,680,1968,1288,1466,1600,0.091405184
84006097151310,744,1491,747,1218,1473,0.209359606
84006097151311,1034,2272,1238,1403,1845,0.315039202
84006097151401,1197,2419,1222,1240,1334,0.075806452
84006097151402,1841,3329,1488,1098,1176,0.071038251
84006097151502,1607,2977,1370,1271,1527,0.201416208
84006097151503,87,1377,1290,2001,1797,-0.101949025
84006097151504,304,1316,1012,1284,1637,0.274922118
84006097151601,427,1680,1253,1637,1671,0.020769701
84006097151602,245,1861,1616,1686,1715,0.017200474
84006097151700,1559,2697,1138,1212,1308,0.079207921
84006097151800,829,2048,1219,1266,1483,0.171406003
84006097151900,1027,1398,371,1029,1071,0.040816327
84006097152000,829,920,91,960,1103,0.148958333
84006097152100,514,1053,539,1113,1390,0.248876909
84006097152201,1045,1687,642,1138,1328,0.166959578
84006097152202,1319,2738,1419,1131,1475,0.304155615
84006097152203,1201,1810,609,1011,1181,0.168150346
84006097152300,492,1818,1326,1323,1676,0.266817838
84006097152400,1039,4287,3248,1997,2067,0.035052579
84006097152501,883,1671,788,1415,1507,0.065017668
84006097152502,586,1513,927,1175,1537,0.308085106
84006097152600,566,3176,2610,1779,1815,0.020236088
84006097152701,713,2160,1447,1424,1672,0.174157303
84006097152702,1095,2091,996,1251,1463,0.169464428
84006097152801,583,1949,1366,1371,1397,0.01896426
84006097152802,2088,2775,687,1002,1125,0.122754491
84006097152903,919,1490,571,1037,1292,0.245901639
84006097152904,760,1976,1216,1493,1671,0.119223041
84006097152905,581,1581,1000,1342,1617,0.204918033
84006097152906,734,2077,1343,1382,1805,0.306078148
84006097153001,1630,2490,860,991,1103,0.113017154
84006097153002,1088,1913,825,1148,1406,0.224738676
84006097153003,978,2028,1050,1195,1412,0.181589958
84006097153005,856,2470,1614,1488,1687,0.133736559
84006097153006,1050,2830,1780,1417,1632,0.151729005
84006097153102,689,1453,764,1233,1252,0.01540957
84006097153103,733,1409,676,1214,1185,-0.023887974
84006097153104,920,1176,256,1084,1135,0.04704797
84006097153200,1364,2523,1159,1201,1384,0.152373022
84006097153300,1709,3683,1974,1337,1506,0.126402393
84006097153401,1435,2878,1443,1224,1351,0.10375817
84006097153403,585,1556,971,1130,1378,0.219469027
84006097153404,662,1844,1182,1026,1154,0.124756335
84006097153501,582,1952,1370,1204,1528,0.26910299
84006097153502,423,1693,1270,924,1439,0.557359307
84006097153600,840,2350,1510,1412,1285,-0.089943343
84006097153703,631,1650,1019,953,1111,0.165792235
84006097153704,810,1687,877,947,1128,0.191129884
84006097153705,607,1745,1138,1089,1261,0.157943067
84006097153706,459,1928,1469,1141,1160,0.01665206
84006097153801,1146,3132,1986,1748,1836,0.050343249
84006097153804,258,1185,927,1743,2070,0.187607573
84006097153806,282,1298,1016,1427,1484,0.039943938
84006097153807,139,1378,1239,1811,2040,0.126449475
84006097153808,463,1482,1019,1185,1322,0.115611814
84006097153809,408,1577,1169,1354,1329,-0.018463811
84006097153901,622,2128,1506,1096,1607,0.466240876
84006097153902,1009,1717,708,1187,1307,0.101095198
84006097153903,615,1690,1075,1298,1612,0.241910632
84006097154000,332,1047,715,1110,1064,-0.041441441
84006097154100,584,1382,798,1513,1173,-0.224719101
84006097154201,685,1349,664,1053,995,-0.055080722
84006097154202,518,2264,1746,1563,1263,-0.19193858
84006097154302,402,1607,1205,1234,1363,0.104538088
84006097154303,177,758,581,1267,1398,0.103393844
84006097154304,397,958,561,1319,1000,-0.241849886
84006097990100,0,0,0,-666666666,-666666666,0